Sechin	Russia
Larry Van Tuyl	Warren Buffett
Inditex	Prudential
Roche	Novartis
Clippers	NBA|Steve Ballmer|Donald Sterling
NYC	Belgium|Bloomberg|Watching USA
Trump 's Islam	Daley
Honda	US|Texas|Takata
Meg Whitman	California
SeaWorld Trainer Barbie	Mattel
Weills	UCSF
Rangel	McCrery
Rich Sit	Sandy
Chiasma	U.S. FDA|FDA
Eurozone Faces Tough Bank Regime	Cyprus
Becky Quick Speaks	Billionaire Investor Warren Buffett Ahead of Berkshire Hathaway?|CNBC
Bombardier	Delta|China
China NPC	Asia|Caixin
NBC-WSJ	GOP|Hillary|Obama|Trump|Cruz
Waterloo	Wisconsin|USA
GE	China|AAPL|Immelt|YHOO|Ed Garden|Bank BPH|John Rice|Boston|Energy|PBR|General Electric Co|Cramer|MSFT|TIF|ANF|Haier|Bernie|GOOGL|Toyota|CVS|IBM|Abercrombie|ZG|SBUX|Connecticut|Jeff Immelt|NFLX|AIG|CCL|STI|TEL|Dell|INTC
Heinz	Berkshire Hathaway|Buffett
Carol Yu	Sohu
GM	Ford|UA|LG|Tennessee|CNBC|Apple|ATHM|Michigan|Europe|MDVN|DHI|Barra|Barron|Malibu|Chevy Bolt|Electric Cars|North America|Uzbekistan|Japan
Ken Moelis	CNBC|Andrew Ross Sorkin|Nelson Peltz
Ma Bell	Fed|US
Stryker	U.S.|Halo
Thomas	Dolan|Bork
MAR	TSLA
Templeton	Hasenstab|Mark Mobius
Chipmaker Marvell	Richard Hill
Loeb	Alibaba|Omaha|Perry|Halvorsen|Coleman|Ackman|Paulson|Tepper|Hertz|Robbins
CNBC Catalyst	CNBC International
Star Trek	CBS
HDFC	Keki Mistry
Nasdaq	NYSE|SEC|IBM|S&P|Jim Cramer|US|Apple|Facebook IPO|Greifeld|Dow|Greece
ACLU	US
Gizmodo	Facebook
Cowboys	NFL|Broncos
South Korea	China|Japan|Fed|HK|Warren Buffett|ECB|Yoo Il-ho|CNBC|Kaesong|Bank of Thailand|Asia
Branson	China|Weibo|United Tried|Virgin
Edward Snowden	Skype|SXSW
Sandy	U.S.|Caribbean|Joan Weill|Rich Sit
U.S. House	North Korea|Puerto Rico
Jack Dorsey	Square|CNBC|Julia Boorstin|Cramer
Obama?	IRA
Jerry Seinfeld	Amelia Island|Ferrari
Christie	GOP|Trump|Dylan|NJ Supreme Court|Iowa|Liu Yiqian|Modigliani|Detroit|China
LeBron James	Cleveland|Nike|Jessica Alba
Dallas Fed	Rob Kaplan|CNBC|Steve Liesman|Fed
Wesfarmers	Britain|Australia
BES	Portugal
Fisher Island	Fla.
Boston Fed	QE
FanDuel	New York
Paul Tudor Jones	Palm Beach
Arizona	Utah|Apple|Idaho|Baptist Foundation|Court OKs Corp.
Icahn Enterprises	CNBC|Carl Icahn
Novogratz	Brazil
Baltics	Hong Kong|John Greenwood
Merkel	Greece|Germany|Obama|ECB|Britain|EU|China|Fuchs|US|Europe|Syria|Athens
Perrigo	Joseph Papa
Harry Reid	Senate|Nevada
Eric Schmidt	Google|Fed|Motorola|Microsoft
Mazda	Takata|Japan
de Klerk	Frederik Willem|CNBC
European Central Bank	CNBC|Bank of England|Germany|Italy|Yves Mersch|Axel Weber|Intesa Sanpaolo
Hamilton	Taylor Swift
Sylvia Burwell	Obama
AT&T	FCC|T-Mobile|BellSouth|DirecTV|John Legere|Comcast|Apple|Faber|Verizon|US|CNBC|Leap Wireless|Intel|Ericsson|CIA|McDowell|DIRECTV
PARIS	FRANKFURT|DUBLIN|NEW YORK
ZG	ANF|YHOO|PBR|GE
Electric Cars	GM
Health Care	Cisco
Ferrari	Amelia Island|Pebble Beach|Jerry Seinfeld
Yellen	Fed|US|Trump|Fedmas|Summers|CNBC|S&P|Asia|CNBC Fed|JPMorgan|Rand Paul|Obama|Cramer|Draghi|Metro|Senate|Apple|U.S.|Dow|Japan|Lebovitz|Jimmy Dunne|Schiff
Ohio	Kasich|Mandel|Florida|Africa|McDonald 's Chicken McGriddle|Youngstown|Texas|Hilcorp|Senate
Meerkat	MLB|Periscope
Maryland Obamacare	Oregon
Nokia-Microsoft	Asia
Merrill	Fed
Navistar	Pickens Group
Corrigan	Goldman Sachs
Man Group	ArcelorMittal
U.S. FDA	Chiasma
Hamas	Gaza|Israel
France?	Southern Europe
LG	GM|Chevy Bolt|Selfie
Las Vegas	Andre Agassi|Sin City|Mike Tyson|T-Mobile
Hormel Foods	Jim Cramer
George Quinn	Zurich Insurance Group
TJX	Ross
Califf	U.S. Senate
Ericsson	Apple|China|Leif Johansson|Facebook|Samsung|Sony|Xiaomi|AT&T|India
Audi	Tesla|VW
Epix	Hulu|Netflix
Bill de Blasio	New York City
Frederik Willem	CNBC|de Klerk
Steve Case	America
SKorea	Japan|China|Taiwan
Jeb	Ted Cruz|Hillary
Heated Brooklyn	Sanders|Clinton
Gardasil	Merck
Khan	London|Labour
Cheney	George H.W. Bush
CTO	Facebook
Haier	GE|China
Levi Strauss & Co.	Harmit Singh
Hey Loeb	Dow Chemical|Buffett
New York-Boston	Boston Travel
NFL Hall	Famer Jerry Rice
Carnegie Mellon	Marvell Technology
Charif Souki	Cheniere|Carl Icahn
Carlo Ferro	STMicroelectronics
Mohamed Rafique	Maybank Group
Margrethe Vestager	European Union|CNBC Media Alert|CNBC
Conor McGregor	UFC|MMA
Edwards	Clinton|Obama
Lebovitz	JPMorgan|Yellen
Standard & Poor	CNBC|Moritz Kraemer
Athens	Greece|Merkel|BHP
Abbott Labs	St. Jude Medical
Scavino	Trump
Imphal	Myanmar|India
Zielke	Commerzbank
Government Would Rescue Bank of America	Warren Buffett
James Bond?	Aston Martin
LightSquared	FCC
EDF	Europe
Appaloosa	SunEdison
Tim	Marissa
Hinrichs	Ford
LMT	CUDA
Rubio	Cruz|US|Jeb Bush|Clinton|GOP|Trump|Sanders|Billionaire Steyer|Trump?|Adelson|Hillary|NBC|Obama|Kochs
Wienerberger	Willy Van Riet
Colombia	Romania
Reform NSA	Barack Obama
LMC	Western Europe
NetApp	SolidFire
IPIC	Malaysia|Abu Dhabi
Hillar Clinton	Wall St
Le	China
Torex Gold	Mexico
Abe	Japan|UK|Brexit|Abenomics|HSBC|Kuroda|BOJ
Digitas	Publicis
Tesla Energy	Tesla
Jerry	Ben|Tom|Sanders
Li	China|Modi
Kevin Brady	Washington|CNBC Digital Video|U.S.|CNBC
General Electric	Facebook
Washington Post	Bezos|Trump
Rajaratnam	US
Deese	White House|Supreme Court
HP Inc.	HP|Hewlett Packard Enterprise
Hogan	Beltway Drama
Paul Meeks	FANG
Walker?	Alaska
LA	Petersen Automotive Museum
Merkel Obama	Europe
Dell	Icahn|NTT Data|Microsoft|Apple|Lenovo|Toyota|Chanos|EMC|Japan|GE|Ackman|Abercrombie|Intel
LH	HAL|UAL|BLL
1-United Airlines	NZ|Air NZ
Everson	GOP
Jordan	U.S.|Egypt|Syria|James
National Baseball Hall of Fame	NYSE
George III	Jack Lew
UniCredit	Italy|ECB
Falcon	SpaceX
Mahaney	Yahoo
Zika	US|CDC|U.S.|Texas|Quest Diagnostics|Rollins|Puerto Rico|Brussels|Brazil|Congress
Strengthen Power Grid	AMSC
Dylan	Christie|McCartney
RZA	Wu-Tang Clan
Chesapeake	Williams|Energy
Castro	Cuba
Dimon	JPMorgan|Treasury|US|JP Morgan|Davos|Madoff
McPick	McDonald
Moonves	CBS|Time Warner|Diller|Apple
J. Peterman	Seinfeld
Sohu	Carol Yu
Suze Orman	Dos|Karen Finerman
Vince Farrell	Vladimir|Mark Haines|Europe|Fed
Madoff	Picower|Supreme Court|Toyota|SEC|Merkin|Brooklyn|JPMorgan|AIG|Ernst & Young|Fairfield|Milken|Dimon
Fyrwald	Univar|Syngenta
Juncker	EU|Luxembourg
Valeant	Buffett|SEC|Senate|Ackman
Sun Pacific Bank	California
Serbia	Balkans|EU
Hiroaki Nakanishi	CNBC
CNBC Burlington Northern	Warren Buffett
Hastert	House
Ajit Jain	Buffett
US Justice Department	North Carolina|Baker Hughes|Halliburton
John Greenwood	Hong Kong|Baltics
Quinn	Illinois
PetroChina	Bernstein
Wolf	Bernanke
Fannie	Treasury|S&P|Paulson|Intel|Bernstein|Ackman|Freddie
Zimmer	FDA
Bill Gurley	Peter Thiel
Dos	Suze Orman
Mark Grant	US
Political Beliefs Into ` Blind Trust	CNBC|Warren Buffett
Jim Cramer	CNBC|Joe Papa|Oscar Munoz|United Airlines|Tim Cook|SolarCity|Greifeld|Nasdaq|McDonald|Victoria|PayPal|Hormel Foods|Amazon|CNBC Media Alert|Tyson Foods?|Buffalo Wild Wings|Clorox
Marissa	Tim
Blackstone	US|Schwarzman|Trump|Dalian Wanda|Stephen Schwarzman|Hayman Capital Management Managing Partner Kyle Bass Speak|CNBC|China|David Faber|Steve Schwarzman|UFC|Strategic Hotels & Resorts
Nationalize Banks	Chavez
Newark	Zuckerberg|Facebook
Publicis	Digitas|Europe
GTM Research	China
Hilla	Islamic State
Abbott	India|Alere|Mylan
Kmart	Sears
SAC	FBI|Martoma|Goldman Sachs|Mathew Martoma
SAB	Anheuser-Busch InBev|Asahi
Chris Paul	NBA|California
Xerox	Pfizer|Boeing
David Tepper	Florida|New Jersey
US Airlines	Senate
Malaysia Airlines	Mueller|CIA
SAP	U.S.
Spain	Italy|Catalonia|ECB|France|Australia|Yen|Ireland|Kravis|Carlos Slim|El Mundo|Felipe|Greece|Jose Maria Aznar|U.S.|FCC
Redstone Tells CNBC	CBS|Viacom
Andre Agassi	CNBC|Las Vegas
Bernard Madoff	Andrew
N.America	Omnicom
Pfizer	Allergan|AstraZeneca|Xerox|Boeing|Ford|Hp|UnitedHealth|Putin|Astra
Oman	Qatar|Bahrain
Tim Cook	Apple|China|CNBC|Cramer|America|FBI|Schmidt|Jim Cramer?|Google|US|Jim Cramer
Glenda Long	CNBC|Asia
Volvo	Daimler|China
Merck	Gilead|CNBC|Kenneth Frazier|Idenix|Gardasil|Europe|Meg Tirrell
Asia	China|US|BOJ|Europe|Japan|CNBC|Fed|NPC|Australia|Doha|RBA|Iran|Hong Kong|Beijing|Singapore|Netflix|Bank of Korea|OPEC|Lombok Lodge|Donald Trump|Shanghai|Bank of Japan|Will Fed|Philippines|Pakistan|Apple|Warren Buffett|Dmitry Medvedev|Ash Carter|IEA|Tokyo|UAE|Datai|North America|France|Deloitte|Caixin|Lazada|Hitachi|Rodrigo Duterte|PMI|Glenda Long|Goldman|ECB|Yellen|CNBC World Television Network|Didi Kuaidi|Manulife Asset Management Partner|Russia|China Inc|Global Financial Markets|FOMC|Knight Frank|LVMH|Barry Callebaut|Bain Capital|China NPC|Re|NZ|Upper House|Societe Generale|BMW|South Korea|Nokia-Microsoft|HK|CNBC Sports|JPMorgan
Buy Wendy	Najarian
Jeff Smith	Darden|CNBC|David Faber
El-Erian	Congressional|Japan|Fed|Washington|Pimco|China|Trump|Allianz|PIMCO
Norfolk Southern	Virginia|U.S.
Calpers	Moody
Cairo	Gaza|Israel
India	China|Xiaomi|Modi|Vodafone|Hutch|Jaitley|Lincoln House|Myanmar|Surat|Mumbai|Russia|Yuvraj Singh|WPP|Apple|Kingfisher|FDI|BRIC|Lenovo|Ireland|US|Brazil|Meeker|Australia|GIC|Hong Kong|Africa|Sequoia|Cyrus Poonawalla|IBM|Narendra Modi|OYO Rooms|Vijay Mallya|Google|Jharia|Ericsson|Imphal|KidZania|Singapore|Sri Lanka|Flipkart|UB Group|Buffett|Reserve Bank of India|Abbott
Bank of Korea	Asia|RBA|China|US
Jia Yueting	LeEco|Apple
Fortescue	Andrew Forrest
Milan	Starbucks|Italy|Percassi|Ferarri
APC	Anadarko Petroleum Corp
DBS	CNBC|Danamon|Piyush Gupta
McDonald 's Chicken McGriddle	Ohio
AMCU	Sibanye Gold|Africa
Shakira	Leonardo
Reserve Bank of India?	Rajan
Not China Unicom	China
Zill Bill	Ad Space & Doggy Doo
Cam Newton	Broncos
Mongolia	Rio Tinto|Rio
Pauline Chiou	CNBC
Damascus	ISIS
Former House	Dennis Hastert
MERCK & CO INC	GILEAD SCIENCES INC
ROBERT IGER	BLOOMBERG
Hatch	U.S.|House|Puerto Rico
Cerberus	US
Musk	Tesla|Hyperloop
Adele | Week	VW|Paris
Janis Joplin?	Porsche
William	UK|Kate
Icahn	Apple|Ackman|Dell|US|Trump|China|BlackRock|Buffett|Reckson|Herbalife|BOJ|Sirius|Cramer|Andreessen|Trump?|Microsoft|Atlantic City|Hertz|Nader|Thiel
US Supreme Court	Paul Allen
Lee Cooperman	Omega
Federal Reserve Bank of Atlanta	Steve Liesman|Dennis Lockhart|CNBC
Maybank Group	Mohamed Rafique
Pauline Seow	CNBC|Asia Pacific
Quest Diagnostics	Zika|U.S.|US
GCO	BOJA|HIBB
CNBC Media Alert	CNBC|Leslie Moonves|JPMorgan Chase|Ted Cruz|Susan Li|Joe Papa|Neel Kashkari|Margrethe Vestager|Jim Cramer|CBS Corporation|Phil Knight|Bill Ackman|Nike|European Union|Pershing Square|Sara Eisen|Lehman Brothers|Jamie Dimon|Justin Trudeau|Erin Callan|Federal Reserve Bank of Minneapolis
Qualcomm	Sprint|Katz|China
N.Y.	ADT|SEC|Apple
Ivanka Trump	China
Paul Marshall	Brexit|Crispin Odey
Aron	AMC|Starwood
Carly Fiorina	Ted Cruz|Ted Cruz?|Trump|Clinton|Donald Trump
Paul	Trump
Starwood	Marriott|China|AMC|Morgan Stanley|Aron
Mickey	Disney|Cramer
Clinton	Trump|Sanders|Obama|GOP|South Carolina|CNBC|NBC|Iowa|Edwards|Rubio|Pennsylvania|Denmark|De Blasio|Mississippi|Wall Street|Reagan|Carson|Giuliani|Craig|Allergan|Romney|Main Street|Carly Fiorina|Michigan|Bloomberg|Norquist|Fiorina|Wall St.|Idaho|Apple|Indiana|Warren Buffett|Steve Liesman|Heated Brooklyn
Carla Bruni-Sarkozy	CNBC
East Coast	West Coast
Didi Kuaidi	Lyft|Asia
Marissa Mayer	Yahoo|SunTrust
Uganda	Egypt|Citadel Capital
CNBC Digital Video	Kevin Brady|Washington|CNBC|U.S.
U.K.	Facebook|Crescenzi
Experian	Brazil
Fat Advisory Committee	FDA
Samuel L. Jackson	Donald Trump
Bank Negara	Zeti Akhtar Aziz|CNBC
EchoStar	HBO|Time Warner
Diane von Furstenberg	CNBC
Hedgie Palihapitiya	Amazon
Macy 's	United Airlines|Netflix|Martha Stewart
Havas	Yannick Bollor?|CNBC
Mario Gabelli	Verizon
Keki Mistry	HDFC
WSM	IBM|NFLX
Lafarge	Holcim|CRH
ECB	Draghi|Fed|Italy|China|France|Mersch|Germany|Merkel|Cyprus|Europe|Spain|Trichet|Mario Draghi|Cramer|Bundesbank|Soros|Janet Yellen|Japan|South Korea|US|Williams|EU|PBOC|Asia|Bernanke|UniCredit|New York|OPEC|Jim O'Neill|ING Group|CNBC|US Treasury|Weidmann
Congress	Puerto Rico|Obama|U.S.|Treasury|Fed|China|White House|US|Venezuela|SEC|Guantanamo Bay|Japan|Juniper|Pacific|TPP|Saudi Arabia|North Korea|Zika|S&P|Syria|Chadwick|Conrad
EXPR	CMG|CBS|DRI|ROST
Michael Fassbender	Steve Jobs
Volkswagen	US|U.S.|DOJ|Porsche|FTC|VW|CNBC|Bob Lutz|U.S. FTC|ECA|Kentucky|Martin Winterkorn|Wolfsburg|Glencore|AutoNation|US FTC|Matthias Mueller
Orszag	White House|Citi
DreamWorks Animation	Comcast|Centerview Partners
Strategic Hotels & Resorts	Blackstone
Nintendo	Tatsumi Kimishima|Mario|Iwata|Microsoft|Sony
Allen Ma	HKSTP|Hong Kong Science Park
Dan Gilbert	Cleveland Cavaliers|Detroit
Alexander	Kobi
Sabanci	Enerjisa
BEA	US
Ubben	ValueAct
Will Ferrell	Trump
Ted Cruz Picks Carly Fiorina	Bernie Sanders
Google Chromecast	Netflix
US Treasurys	Fed
Name Lew Treasury	Obama
Millennials	NBC
Willy Van Riet	Wienerberger
BBY	NFLX|JCP|NKE
Oracle	Silicon Valley
BBT	VIAB|CTXS|UAL
Whoopi Goldberg	Oprah
Hunter Mahan	PGA
Academy Sports eye Sports Authority	Dick
Advisory Board	Peter L. Briger Jr.
Craig	Clinton
Tmall	Alibaba
Carlos Slim	Spain
Kalanick	China
CPGX	WFM|VIAB|TIF
KidZania London	UK
Peter Thiel	Bill Gurley|Trump|Google
Yanukovich	Ukraine
Former Fed	Alan Blinder
CME Group	New York|UAE
Aereo TV	US
WYNN	ATVI|GPRO|BA|CBS|NFLX|HON|ITT|AIG
Carolyn Fairbairn	CNBC
Chicago	Illinois|S&P|Warren Buffett|Busch|Barack Obama|GOP|O'Hare|Starbucks|America|Boeing
STMP	NCLH
HARRY REID	MSNBC|SCALIA|OBAMA|U.S.
CEBR	Singapore
Hyman Roth	Cuba|US
Williams	Fed|US|SEC|NFL|Energy|China|Chesapeake|US Fed|San Francisco Fed|ECB
Anheuser-Busch	NFL
Donald Trump?	GOP|Hillary Clinton|America
Fundstrat	S&P
DARPA	Inovio Pharmaceuticals
BIIB	CVS|IMS
Mozart	Beethoven
Reserve Bank of India	India
Heather Xie	Global Logistic Properties
POM	Supreme Court
Petersen Automotive Museum	LA
Murkowski	US
Hilton	Santa
Mahathir	Anwar
Tatsumi Kimishima	Nintendo
Omega	Leon Cooperman|Lee Cooperman
Bank	CFTC|Belarus|Russia|Italy|HBOS|New York|Peru
Daniel Coster	Apple
Hulk Hogan	Gawker
Shari Redstone	Viacom|CNBC|Faber
Cape Breton	Trump
Deutsche Boerse	Stock Exchange|UK
Central Bank	China
Lula	Brazil|Rousseff
Yang Weiguo	Wangzhou Fortune
LSE	Borsa Italiana|Apple
France Leeway	EU
Pandora	ZenoRadio|Westergren|Apple|Europe|Greece
Alabama	TVA
Conrad	Congress|US
Coca-Cola	Crimea|Russia|Ukraine|Buffett
ANTONIN SCALIA	U.S.
Bernie	Hillary|GE|Cruz-Kasich|Howard Dean
Las Vegas Sands	Macau|U.S.|Adelson
Gawker	Hulk Hogan
Munger Sandwich	California
O'Donnell	CBS
Rubenstein	Carlyle
Bill Poole	Healthcare|Dick Fuld
QE	Fed|Boston Fed
Michael Pearson	Warren Buffett
David Cameron	UK|Brexit
Caijing	CITIC
Deutsche Post DHL	Lawrence A Rosen
Kiev	EU
Caixin	Asia|China NPC
Union	VW
AAPL	GE|SBUX|NOC|TEL|LLY|PNRA|GRMN|NFLX|FDX|IBM|CVS|BHI|CMG|TIF|Apple Inc|STI|AIG|BA
Colbert	South Carolina
Abby Joseph Cohen	Goldman Sachs
Geert Peeters	CLP Holdings
Huawei	Apple|China|Xiaomi|US|U.S.|Samsung|HTC
ASCO	AstraZeneca
Arthur Lang	CapitaLand Limited
Coors	AB InBev|SABMiller
LSI	CNBC
Powell	Fed
Anna	Elsa|Disney
DCN	France
Mylan	Abbott|Drugmakers Mallinckrodt
LG Household	China
George Steinbrenner	Silver Shield Foundation
Kate Moss	China
Dave Grohl	Madison Square Garden|Eddie Vedder|Bon Jovi
Legg Mason	Bill Miller|Warren Buffett
1-Ferro Corp	Lazard
US Fed	IMF|Indonesia|Williams
Claman	Buffett|CNBC
Snoop Dogg	Pabst
Cashin	Fed|Lacker|China|Treasury|S&P|Siegel
John Rice	China|CNBC|GE
Havana	US|Chanel|Jay Leno
Rusal	Alexandra Bouriko
Great Plains	Cayman Island
Sass	Allergan
Bergoglio	Argentina
Bitcoin	Europe|Winklevoss|England|Greece?
Siegel	China|Fed|Cashin
Colorado	America|Silicon Valley|CNBC|Amazon|U.S.
Westergren	Pandora
Sebelius	Jon Stewart
BrightRoll	Yahoo
Armstrong	Verizon|Yahoo|AOL
IHS	China|Iran
JP Morgan	Davos|Dimon
Washington	CNBC|Cramer|CNBC Digital Video|Citi|Pickens|U.S.|Pimco|Alaska|El-Erian|Google|America|Kevin Brady|Joe Biden|NFL|Senate|Warren Buffett|US|NSA|California|Chadwick|Fagen
Rio	BHP|China|S&P|Mongolia
Thiam	Credit Suisse
MannKind	Tourbillon
Brent Celek	NFL
OBAMA	HARRY REID|U.S.|SCALIA|MOSUL|MSNBC
BABA	YHOO
World Bank Group	Wolfowitz
Caribbean	Pirates|Sandy
Tadashi Yanai	UNIQLO
AMAC	China
Kroton	Morgan Stanley|Brazil
AEC	ASEAN
Sydney	APEC|Paris|Bush
Avis Budget	Tim Hortons
Butler	Brad Stevens
McCormick	UK
Jane Wells	Mark Haines|CNBC
U.S. FTC	Volkswagen
Grantham	GMO
Jensen	Dalio
Plotkin	Edelman
Borsa Italiana	LSE
Kevin O'Leary	Facebook
Clorox	Jim Cramer|Cramer
Ardagh	Rexam|Ball Corp
Meeks	Amazon|Yahoo
Vodafone	Verizon|India|Hutch
CTXS	VIAB|UAL|BBT
Citadel	Ken Griffin|US
Bethany Mota	YouTube
NFL	Harvard|Washington|CBS|Jameis Winston|London|FCC|Tom Brady|Williams|Redskins|Isaiah Kacyvenski|Roethlisberger|Nike|Peyton Manning|NBC|Cowboys|St Louis Rams|Goodell|LA.|Marc Trestman|Disney|National Football League|Rex Ryan|Anheuser-Busch|Iger|Aaron Hernandez|Broncos|Brent Celek
Jens Weidmann	CNBC
MSCI	China|Baidu|Alibaba
Cisco Systems Inc	CSCO
Bronx	Yankees
Frydenberg	Australia
Panama Canal	US|Nicaragua
Harold Hamm	Trump|U.S.|US
PSI	Singapore
Salah Abdeslam	Paris|Belgium
John McAfee	Google|House|Intel|Microsoft|FBI
Dow Chemical	Hey Loeb|WSJ|Dupont|Buffett
McDonald	Cramer|LeBron|Ray Kroc|Wendy|Jim Cramer|Micheal Keaton|McPick|Burger King|Starbucks|Japan|Dunkin|North Asia
North Carolina	CNBC|New York|Top States|Pennsylvania|Shake Shack|New Beer City|US Justice Department
Kirkuk	Turkey
Martin Winterkorn	Volkswagen
Navy	Sonia Syngal|1-Gap Inc|Iraq|ISIS|Europe|US|Gap Inc
Pebble	Kickstarter
PETER THIEL	DAVID SACKS
Playboy Mansion	Hef
FuelCell	Exxon
Spotify	SoundCloud|Apple|Amazon
GSK	J&J|Astra
Newell Rubbermaid - Jarden	Cramer
Berkshire Hathaway	Warren Buffett?|Buffett|Warren Buffett|Phillips|S&P|Todd Combs|UBS|Heinz|Purchase Lubrizol
KMB	TSLA|NWL|GPRO
Dmitry Medvedev	Asia|Russia
Dalio	Fed|Bridgewater|US|Jensen|Cohn|U.S.|Davos|Bernanke
WalMart	Ford
PwC	Dennis Nally
Ireland	UK|China|India|Spain
Peltz	DuPont|Sonnenfeld|Cramer
AAA	ExxonMobil|S&P
Jeff Williams	Apple
Bernstein	Fannie|IRS|PetroChina
AC Milan	Berlusconi|Alibaba|Italy|Jack Ma
Alfa Romeo	Italy|Renzi
Chavez	Caruso-Cabrera|Iran|Venezuela|Nationalize Banks|Cuba
Kerry	Iran|London|Brussels
Barry Callebaut	Asia
VRX	TWTR|DAL|BAC|CME
Baghdad	Vienna|ISIS
Hillary	Trump|Bernie|Cruz|NBC-WSJ|Bloomberg|Rubio|Cruz-Kasich|Bill Clinton-?|Buffett|Barack|GOP|Warren Buffett|Bill Clinton|Jeb|Wall St.|Silicon Valley?|Howard Dean
Larry Sumers	Fed
TVA	Alabama
Norwegian Aviation Authority	Bergen
ING Group	ECB
Georgia	Russia
Conn.	GOP|Stonington
Tokyo	Japan|Asia|New York
Pennsylvania	Trump|Medicaid|New York|North Carolina|Clinton|Connecticut
Poland	EU|Europe|Romania
Lachlan	James
Philadelphia	Amtrak
NJ Supreme Court	Christie
Yang	Yahoo
CS	NKE|AZO
Ex-Indiana	America|Trump
Holmes	WSJ|FDA
IMS Health	Quintiles
Manulife Asset Management Partner	CNBC|Asia
Poroshenko	Ukraine|Minsk|Putin|Russia
Holcim	Lafarge|CRH
Hillary Clinton	Donald Trump|Trump|Sanders|US|Goldman Sachs|New Hampshire|Bill|Warren Buffett|Leon Cooperman|PBS|Michigan|Ted Cruz|Buffett|Julia Gillard|Jessye Norman|Nebraska|Iowa|Donald Trump?|Bernie Sanders|GOP
LionOre	Norilsk
Bettencourt	Bruni-Sarkozy
Indra Nooyi	Pepsi
Cleveland	LeBron|LeBron James
Gilead	Merck|S&P|LinkedIn|Waxman|Idenix|Amazon|Milligan
Seadrill	Europe
Norsk Hydro	Eivind Kallevik
Worst State for Business	Hawaii
Paramount Studios	Viacom
Mercedes-Benz	Daimler
CVS	AMC|AAPL|GE|HAL|IMS|BIIB|AMGN|SBUX|STI
Vijay Mallya	Kingfisher|India|UB Group
ZNGA	PHM|WBA
Bush	Trump|APEC|Obama|Laffer|Brazil|Buchanan|Howard Cement Alliance|GOP|Putin|Bernanke|Iraq|Sydney
Rubin	Paulson|USA|Geithner
Meirelles	Brazil
Nat	Keystone
Kashkari	Fed|Bernanke|US|Federal Reserve
NOC	AAPL|BHI|GRMN|Libya|BA
Panama Papers	Fed
Li Ka-Shing	Hong Kong
Cramer	Apple|China|Fed|McDonald|Yahoo|Facebook|Wal-Mart|Tesla|Microsoft|Disney|IBM|Caterpillar|Allergan|Netflix|Not USA|Facebook IPO|Piggyback Peltz|Twitter IPO|Mario Draghi|Bin Laden|Intel|UAL|Tina Turner|Hertz|Twitter|Newell Rubbermaid - Jarden|Samsung|Tupperware|Johnson & Johnson|Iger|Intuit|Skechers|Bank of America|Carl Icahn|Petrobras|SEC|Saudi Arabia|S&P|Doha|SanDisk|Etsy|Mattel|Cook|Alibaba|Sherwin-Williams|Warren Buffett|Twitter & Yelp|Greece|LVS|Tom Brady|Haines|Alcoa|Elon Musk|Trump|Bernie Sanders|Williams-Sonoma|Justice Dept.|FANG|Tim Cook|GW Pharma|Mickey|IRA|Hey Ginni Rometty|Jeffrey Gundlach|Zuckerberg|Cisco|Obama|Starbucks|ECB|Jamie Dimon|JC Penney|Amazon|Jack Dorsey|Janet Yellen|Dick Costolo|Republican|GE|Icahn|Brussels|Barbie|Macy|Peltz|Clorox|Washington|Yellen|Boone Pickens|Geithner
Maria Sharapova	CNBC
Zeti Akhtar Aziz	CNBC|Bank Negara
TWTR	DAL|VRX|BAC|CME
W. Virginia	Alpha Natural
Pratt	Air Force
Zimbabwe	China|Cecil
Marina Villeneuve	AP
Royal Bank	Facebook
Bolden	NASA
DreamWorks	Comcast|Spielberg
Barry Diller	Donald Trump|CNBC|InterActiveCorp|IAC|Expedia
VA	Eric Shinseki
Salesforce	DHL|Asia Pacific
Cantor Fitzgerald	Lutnick
Vatican Bank	Pope Francis
Jakarta	Southeast Asia|Twitter
Nestle	L'Oreal
Latvia	Russia|Europe
Jeremy Darroch	CNBC
Bristol	Sanofi
VW	Porsche|TCI|EPA|Justice Department|Paris|New Mexico|Richard Branson|AutoNation|Audi|Europe|U.S.|Toyota|FBI|Wolfsburg|Union|New Jersey|UAW|Adele | Week|Mueller|Volkswagen
Oklahoma Brace For Round Two Of Hail	Texas
Trump VP	Steve Forbes|Ben Carson
Panasonic	Sony
HPE	Whitman
Lesedi La Rona	Lucara
Gates	Buffett|Adelson|Zuckerberg|Forbes|Munger
Krungthai Bank	Thailand|Vorapak Tanyawong
McConnell	Senate|Garland|Obama|U.S. Senate
Rob Lowe	Netflix|Hulu
Tribune	Gannett
Mendes Junior	Petrobras
Batman	Lawrence Ho|Melco|China|Superman
Richemont	Ralph Lauren
Portland	Oregon
UnitedHealth	Pfizer|White House
Isaiah Kacyvenski	NFL
Yoo Il-ho	China|South Korea
Chobani	Coke
Leif Johansson	China|Ericsson
Toshiba US	Westinghouse
DRI	EXPR|ORCL|CBS|CMG|ROST|SONC
Paul Ryan Phones Trump	Cruz
Tom Brokaw	Warren Buffett|NBC
Bulgari	Ahold|Pearson|DaimlerChrysler|UCB
Changi Airport Group?	Lee Seow Hiang|CNBC|Top Travel
Fannie Mae	Freddie Mac
GPRO	ATVI|WYNN|NWL|KMB|TSLA|HON
SoundCloud	Spotify
Sung-Joo Kim	CNBC
Occupy Central	Hong Kong
Harlem	Marcus Samuelsson?
Darren Rovell	Mark Haines
Slovenia	Croatia|Hungary
Connecticut	Maryland|GE|Pennsylvania
Flint	Obama|Michigan|Snyder|America|Lansing|U.S.|EPA|Jake Bronstein
Kuwait	OPEC|U.S.
Securities and Exchange Commission	CNBC
Darren Huston	Priceline
Berkshire Hathaway Eliminates Stakes	Warren Buffett
John Stephens	AT&T Inc.
James	Jordan|Lachlan
BAKER	US|HALLIBURTON
Corona	Modelo Especial
Oppenheimer	US
AT&T Inc.	John Stephens
North Asia	McDonald
Chrysler	Kerkorian
Dreamforce	Microsoft
CNBC Asia Video News Clips	Stock Market
New Zealand	Christchurch
SunTrust	Yahoo|Marissa Mayer
Jimmy Carter	CNBC
Jim Cramer?	Tim Cook|CNBC
Jeff Smisek	Oscar Munoz|United Continental
Cisco	Apple|John Chambers|NSA|Cramer|Chambers|Health Care
Trump	Clinton|GOP|Cruz|US|Bush|Sanders|America|Mexico|Fed|U.S.|Yellen|Kasich|Harold Hamm|Hillary|Soros|China|Obama|Donald|Warren Buffett|Romney|Trump University|Carl Icahn|Japan|Iowa|Apple|Ryan|Fiorina|Rubio|UK|Christie|Ron Paul|Carson|Pennsylvania|Icahn|Ed McMahon|Jack Welch|Hillary Clinton|Nevada|Kim Jong|Puerto Rico|Main Street|Google|CLSA|Adelson|Bezos|Goldwater|Wharton|Grover Norquist|Vermont|Arianna Huffington|Indiana|NBC|Atlantic City|Macy|Brexit|Schwarzenegger|Mitt Romney|Tubman|Peter Thiel|Paul Ryan|Gordon Gekko|Ford|Palin|House|Blackstone|Mississippi|Trump Tower|London?|Blankfein|EU|Wisconsin|Corey Lewandowski|N Korea|CNBC|WEF|Schwarzman|Berkshire|El-Erian|Silicon Valley|New Hampshire|Washington Post|Bill Clinton-?|Canada?|Cramer|SocGen|Idaho|Scavino|Jeb Bush|RNC|William Kristol|Buffett|Goldman|Cilnton|Michigan|NBC-WSJ|Ex-Indiana|Wedbush|Will Ferrell|Lindsey Graham|Koch|Paul|CNN|Harper Lee|Carly Fiorina|Silicon Valley?|Cape Breton|Steve Liesman|Israel
Armour	Andy Murray|Southwestern Energy
Ga.	Alpharetta
U.S. Senate	Obama|McConnell|Pakistan|Califf|Robert Califf
Bezos	Amazon|Washington Post|SpaceX Falcon|CNBC|Zuckerberg|Google|Trump|NASA|Warren Buffett|Wal-Mart|Coke
Jim O'Neill	ECB|Mario Draghi
Julian Assange	SXSW
Pentagon	House of Representatives|Schmidt|Romney|Sen McCain|United Launch|U.S.|Google
Prince	Minnesota|Sues Sinead O'Connor|Google|Donald Trump
Bain	Vista Equity
Warren	Eric Cantor|Pelosi|Cohen|U.S.
Lars Machenil	BNP Paribas
Bangladesh	Manila|New York Fed|US|Topshop|Philip Green
Changi Airport	Singapore|Seoul
Big Sky Country	Montana
Chevrolet	America
HP	HP Inc.|Hewlett Packard Enterprise
Soros	China|Trump|Transocean|Russia|European Union|US|Devon Energy|Europe|HK|ECB|Ukraine
EU Chooses France	IMF
HK	China|Fed|UK|Lee|Glencore|South Korea|Asia|Soros
Moynihan	BofA|Bank of America|HB2 North Carolina|US
Sues Sinead O'Connor	Prince
French Bank	Francis Mayer
Top States	America|CNBC|Virginia|North Carolina|North Dakota
CNBC Europe Video News Clips	Stock Market
Malibu	GM
Lee	Singapore|HK|UK
John Malone	Yahoo|Liberty Media|Rupert Murdoch
Cuba	Castro|US|Chanel|NBA|Obama|Iran|Brussels|Singapore|Hyman|Google|China|Chavez|GOP|Thomas Herzfeld|Russia|Carnival|Orbitz|Hyman Roth|Venezuela|United
Hp	Pfizer|Putin
Khodorkovsky	Russia
Greifeld	Jim Cramer|Nasdaq
Dave	Chuck E. Cheese|Buster
Sarepta	U.S.|FDA
Facebook	Zuckerberg|Google|China|Cramer|US|Brussels|Sandberg|Sony|Mark Zuckerberg|Zynga|PayPal|Apple|IBM|Instagram|YouTube|Buy Amazon|Marriott|Ericsson|Kevin O'Leary|Andreessen|Paris|CTO|Royal Bank|HTC|Bill Gates|EU|ISIS|Gizmodo|U.K.|Najarian|Cox|Samsung|Disney|Adyen|California|Lahore|Amazon|Giants|Twitter|General Electric|Sheryl Sandberg|BOJ|Brazil|Australia|Nepal|Wikipedia|Newark|Silicon Valley|Ebersman
Kate Middleton	Singapore
Lew	Europe|Greece|Treasury|Diller|New China|US|Dodd-Frank|Tsipras|Icahn Talks Dell|US Treasury
Kynikos Associates	CNBC|Jim Chanos
DoubleLine	Gundlach
PBS	Hillary Clinton
PBR	GE|ANF|YHOO|ZG
Peter Fisher	BlackRock
Donald Trump	Hillary Clinton|GOP|Jeb Bush|US|Chris Christie|China|Ted Cruz|Barry Diller|Crossroads After Big New York|CNBC|Biden|Jeff Gundlach|New York|Manta|London|Rodrigo Duterte|Indiana|Carly Fiorina|Carl Icahn|Manhattan|Paul Ryan|George Takei|Asia|Bernie Sanders|Michigan|Prince|Mexico|Mark Zuckerberg|Philippines|Samuel L. Jackson|GOP Donors|Cruz|Bill Clinton|Trump Organization|Ed McMahon|Harper Lee|Republican Presidential Candidate|UK
SandRidge	Cooperman
YHOO	GE|BABA|AMZN|ZG|KBH|INTC|NFLX|ANF|UNH|JCP|ACN|AIG|WFC|TSN|PBR|BHI
McDonalds	McDigital|SXSW
Hayman Capital	China
Larry Fink	CNBC|BlackRock
Bernanke	Fed|Trichet|Wolf|AIG|China|Federal Reserve|ECB|Fed Ready|Pimco|Hire Trichet|Yahoo|Kashkari|Bush|Dalio
St Louis Rams	NFL
Dwayne	Johnson
Hewlett-Packard	Jim Chanos
Pink Star	Sotheby
Austria	Romania|Europe|East|S&P|OMV
Cameron	UK|EU|Miliband|Tata|Panama|Obama|Iain Duncan Smith
Mr Clean	Myanmar
Chicken McNuggets	U.S.
BTIG	Disney
UKRAINE	DANYLYUK
Brexit	UK|Lockhart|Abe|Japan|Paul Marshall|Trump|David Cameron|Fed|U.S.|Crispin Odey|London|EU|Tories
Nike	Louis Vuitton|Adidas|Apple|Phil Knight|Sara Eisen|LeBron James|CNBC|NFL|China|Manny Pacquiao|Cleveland Browns|Dick|CNBC Media Alert|NBA
Sunil Gulati	US
Scotland	White House|UK|Alex Salmond
Ray Dalio	Bridgewater
Fairfield	Merkin|Madoff
Bourne	Matt Damon
Katie Little	CNBC
Fubon	China|Taiwan
Political Unity	Panagiotis Lafazanis
Geithner	USA|Rubin|Paulson|Cramer
Embroiled IRS	Lerner
US Bank	ADP
Expedia	Barry Diller|CNBC|Orbitz
ISIS	Iraq|Obama|US|Brussels|UK|San Bernardino|Hollywood|Navy|West|Putin|FBI|Europe|Silicon Valley|Russia|Damascus|Baghdad|Facebook|White House|Turkey
Bill Clinton-?	Trump|Hillary
U.S. SEC	Aveo Pharmaceuticals
Rajan	Reserve Bank of India?
Rob Kaplan	Steve Liesman|Dallas Fed|CNBC
BLOOMBERG	ROBERT IGER
Kudlow	Obama|Fed|US
NBA	Clippers|Twitter|Cuba|Los Angeles Lakers|Donald Sterling|Nike|Andrew Bogut|Iguodala|Michael Carter-Williams|Africa|Wal-Mart|Steve Ballmer|Chris Paul|Atlanta Hawks|Kobe Bryant|California
Endo	FTC|Herbalife|Activision
SWHC	DSW|SPLS|TSN|NMBL
ADT	N.Y.
GMO	U.S.|Grantham
Tevin Vongvanich	CNBC
ADP	EIA|US Bank|US|Fed
Japan?	Europe
Charles Chao	Sina|Alibaba|Weibo
O'Leary	Apple
Silicon Valley?	Trump|GOP|Hillary|Bill Campbell
Andrew Grove	Silicon Valley|Intel
GW Pharma	Cramer
Fiorina Beat Boxer	California
N. Korea	Kim
China Huarong AM	China Reinsurance|Hong Kong
Castro?	GOP
VIAB	UAL|CTXS|BBT|WFM|TIF|CPGX
United States of Europe	EU Energy
David Jones	Australia
Hindustan	Modi
Greenspan	Buffett|U.S.
Tony	Thatcher|Cherie Blair
LAPD	Google|Waze
TWC	Comcast|Dolan|CMG
Dodd-Frank	Frank|Lew
Iger	Disney|Disney COO|NFL|Cramer|Thomas Staggs
Bakken	North Dakota|Williston
Carson	Trump|GOP|Clinton
Raimondo	Rhode Island|San Francisco
Nakanishi	ABLA|Hitachi
Gaza	Israel|Hamas|Netanyahu|Cairo
Dauman	Viacom
TWX	BBBY|FDX
Mayer	Yahoo|Natch|Alibaba|Tech Star Pogue
Boko Haram	Nigeria
Intel	Alcoa|Silicon Valley|Cramer|CNBC|John McAfee|Andrew Grove|Dell|Microsoft|Snowden|AT&T|EU|Brian Krzanich|Altera|Fannie|Lenovo|IBM
Pinault	AMF
Ron Paul Blames Obama	Goldman
Waze	LAPD|Google
Congressional	El-Erian
Andrew	Bernard Madoff
Jamie Dimon	JPMorgan Chase|Bill Gates|Bernie Sanders?|CNBC Media Alert|Buffett|Hank Paulson|CNBC|Cramer|JPMorgan|US
Verizon Wireless	Verizon
Benihana	Aoki
Never Mind Facebook	Winklevoss Twins
Jeff Weiner	LinkedIn
Trend Micro Inc.	Mahendra Negi
HON	WYNN|ATVI|GPRO
Kevin Entricken	Wolters Kluwer
Gundlach	Fed|DoubleLine|Tesla|Pimco|Apple
Renzi	Italy|Draghi|Alfa Romeo
Trian	DuPont
Darden	Jeff Smith
Kraft Foods	John Cahill
Palo Alto	Zuckerberg
M'bishi Motors	Japan
Loft	London|Amazon
Wells Fargo CEO	Fed
Doha	OPEC|Iran|Asia|Russia|Energy|CNBC|Wilbur Ross|US|Cramer|China|Saudi Arabia Iran|U.S.|EXCLUSIVE-Nigeria|Nigeria|Europe
Corvex	Keith Meister?|Yum Brands
Kohl	Wal-Mart|Macy
Tobin Smith	SEC
O'Hare	Chicago
Ray Rice	Ravens
Frank	Dodd-Frank
Moscow	Russia|OPEC|Ankara|Moody|non-OPEC|Turkey
Narendra Modi	US|Southeast Asia|India|Malaysia|America|Singapore
Putin Hints	Strauss-Kahn
Francis Mayer	French Bank
PTC	FDA
Buffett	Berkshire|Gates|CNBC|Berkshire Hathaway|Coke|Valeant|Adelson|Kass Shorts Berkshire Hathaway Again|Kernen|Fed|Deere|Wells Fargo|Obama|Barack|Heinz|Dow Chemical|Ackman|Greenspan|Warren Buffett|Ajit Jain|Hillary|Florida|Jamie Dimon|Claman|Munger|P&G|India|Hey Loeb|Coca-Cola|Trump|Tesco|Berkshire Feels|Icahn|IBM|Burger King|Hillary Clinton|California|Greece|U.S.|Phillips|America|Precision Castparts
Jim Grant	Fed
Tashfeen Malik	Rizwan Farook|San Bernardino
US Navy	South China Sea|Iran|China
Indiana	PayPal|Sanders|Lugar|Trump|Donald Trump|Miley Cyrus|Clinton|Louisiana|China
Swire Pacific Limited	Martin Cubbon
Louisiana	Indiana
Nielsen	China|Apple
Tupperware	Cramer
PepsiCo	Hugh Johnston|DuPont|Caterpillar
HKSTP	Hong Kong Science Park|Allen Ma
Marcus Samuelsson?	Harlem
China Data Set Negative Tone	US
Vic Gundotra	Google
Fernandez	Argentina|Macri
Sonia Syngal	Navy|1-Gap Inc|Gap Inc
Jeremy Stein	Fed
Atlanta	Kayla Tausche
Hong Kong Science Park	HKSTP|Allen Ma
Bieber	Obama
Zhu	China
Power Corp.	Buy Marsh & McLennan
Mantega	Brazil
FIA	China
Tech	Google
Kodiak	Whiting
Atari	Bushnell
Petsmart	Zumiez|Arqule|Yahoo
Iovine	Dre
Mark Dow	Peter Schiff
Diller	Lew|CBS|Moonves|Icahn Talks Dell
Global	US
McCarthy	House|Paul Ryan|GOP|Boehner|Tea Party
Aeromexico	Delta
Corey Lewandowski	Trump
Bob Lutz	Volkswagen
Fidelity	Timmer|Airbnb|Danoff|Robo
Santa Barbara	Calif.
CMO	Keith Weed|CNBC
Weibo	Branson|Virgin|Charles Chao|Sina|China|Alibaba
Justice Dept	Panama|Sachs|Goldman Sachs
CMG	TWC|LVS|ANF|FDX|BAC|TSLA|EXPR|NFLX|DRI|EMC|CBS|AAPL|LULU|ROST
Jay Leno	Havana|CNBC
CME	Fed|New York|TWTR|BAC|DAL|VRX
Piggyback Peltz	Cramer
Glencore	Lehman|HK|Europe|Xstrata|Volkswagen|Barclays
MOZAMBIQUE	IMF
CMS	Tony Trenkle
George Takei	Donald Trump
LendingTree	Fed
Lowe	Mexico
Federal Reserve	CNBC|Chadwick|US|Stanley Fischer|UBS|Kashkari|Goldman|Bernanke|Steve Liesman
Kickstarter	Pebble
Ford	Google|Mexico|GM|CNBC|US|Barron|Toronto|Microsoft|China|U.S.|Toyota|Phil LeBeau|Trump|Nissan|Hinrichs|Pfizer|Apple|IBM|WalMart
Virgin Atlantic	Google|Delta
Iwata	Nintendo
Fagen	Washington
Staples-Office Depot	FTC
Panagiotis Lafazanis	Political Unity
GRMN	AAPL|BHI|NOC|BA
Shaanxi	Qinghai|Shizuishan
Libya	Canada|UN|Iraq|Obama|Yemen|Somalia|Afghanistan|Khalifa Haftar|Eni|US|Zawiya|Italy|U.N.|NOC
Cooperman	SandRidge|Miller|SEC
DSW	SWHC|NMBL|TSN|SPLS
Hospira	FDA
Alibaba?	Jack Ma
Youngstown	Ohio
Brian Kelly	CNBC
DSM	China|Geraldine Matchett
Vatican After Trip	Pope Francis
OYO Rooms	India
Kenneth Frazier	Meg Tirrell|CNBC|Merck
Pimco	Bill Gross|Trichet|US|Washington|Brown|California|El-Erian|Fed|Janet Yellen|Bernanke|Gundlach|Egypt
Rhode Island	Raimondo|Iceland|San Francisco
John Goodwin	Lego Group
VMware	NSX
Kass Shorts Berkshire Hathaway Again	Buffett
North America	Europe|Kate Spade|GM|Asia
Fischer	Fed|US
Portugal	BES
York Times	Paris
Purchase Lubrizol	Berkshire Hathaway
Ballmer	Microsoft|Nokia
Bork	Thomas
Alnylam	Novartis
Borg	Santelli|Cruz
Crimea	Russia|Coca-Cola|Moldova|US|Ukraine
ING	Goldman|Nomura|China|Turkey|ANZ|Barclays
Maine	LePage
DOJ	Apple|USA Today|Lance Armstrong|Chesapeake Energy|Panama|Volkswagen
Umicore	BASF|U.S.
AMGN	CVS|HAL|AMC
Cheung Kong	Li Ka-shing
Lansing	Flint
Meg Tirrell	Merck|CNBC|Kenneth Frazier
Alberta	Canada|California
Altera	Intel
Mediaset	Berlusconi
Ecuador	IMF
Sanders	Clinton|Trump|Iowa|Heated Brooklyn|Hillary Clinton|Kasich|Indiana|Cruz|Carl Icahn|Denmark|Ben|Jerry|U.S.|Rubio|Wisconsin|Wall St.
Australia	Asia|China|Japan|Britain|Westpac|Singapore|India|KidZania|Apple|Wesfarmers|AB Inbev|Europe|NZ|Canada|Facebook|Asia-Pacific|David Jones|Knight Frank|US|Frydenberg|Kuala Lumpur|Spain|Goldman Sachs
George Soros	Pharrell|Russia|Bill Gates|Bob Diamond
Stanley Fischer	Steve Liesman|CNBC|Federal Reserve
Tiger	Jordan Spieth
Fastweb Board	Swisscom
Bernie Sanders	Iowa|New Hampshire|Hillary Clinton|Ex-Democratic|Donald Trump|US|Ted Cruz Picks Carly Fiorina|UBS|Cramer|Bill Clinton
Birol	IEA
Alexandra Bouriko	Rusal
Waffle House	Carolina Panthers
Ben	Jerry|Sanders
Michael Corbat	Citi
SUMNER REDSTONE	VIACOM|DAUMAN
Pierre Moscovici	European Commissioner for Economic & Financial Affairs|CNBC
San Francisco Fed	Steve Liesman|CNBC|John Williams|US|Williams
Canelo	Showtime|HBO
Syed Farook	FBI|Apple|San Bernardino
Lagarde	IMF|Schaeuble|CNBC|Greece
Shinji Fukuyo	Suntory|Japan
Time	IBM|Donald
Yogi Berra	Jimmy Lee
O'Malley	GOP|Boulder
Pope	White House|Obama|US|Notre Dame|Pope Francis
Carlos Ghosn	CNBC
Jonathan Tisch	Giants
Pacific	Congress
Cleveland Cavaliers	Dan Gilbert|Detroit
MMM	SVU|WHR
SBA	Maria Contreras-Sweet|CNBC
O'Brien	Katsuyama
Honeywell	Google
Lower TV	CBS Profit Falls
MMA	Conor McGregor|UFC
Johnson & Johnson	Cramer|Carlyle Group
Druckenmiller	Fed|IBM
Picower	Madoff
Broadway Producers	Julie Taymor
Paris Attacks	Abdeslam
BAC	CME|VRX|CMG|TWTR|ANF|DAL
Encino	Calif.
BAA	Ferrovial
Robin Hood	Party
McDowell	BellSouth|AT&T|FCC
Taylor Swift	Bratz|Britney|YouTube|Hamilton
Coleman	Alibaba|Paulson|Halvorsen|Loeb
Medtronic	FDA|U.S.
Nathan Blecharcyzk	China|Airbnb
Putin	Russia|Ukraine|Syria|United States|Pfizer|APEC|France|ISIS|Iceland|Hollande|Bush|West|Hp|Minsk|Obama|Assad|Panama|Poroshenko
Coke	Berkshire|Warren Buffett|Pepsi|Buffett|South Africa|Bezos|CNBC|Wal-Mart|Chobani
El Nino	California|US
Maria Contreras-Sweet	CNBC|SBA
Oasis	Amazon
Precision Castparts	Buffett
Dallas Mavericks	CNBC|Mark Cuban
Chanel	Cuba|Havana
Alpharetta	Ga.
Merlin Entertainments	Alton Towers
Clay Aiken	NC
Secret Angels	Victoria
Dennis Hastert	Former House
STI	SBUX|AAPL|CVS|GE
STJ	RTN
Macri	Argentina|Fernandez|Panama
De Blasio	Clinton
Ferrovial	Broadspectrum|BAA
Barney Frank	Ted Cruz
Martin	ICAP|Tullett Prebon
Felipe Calderon	Egypt
Paramount	Viacom
McClendon	Oklahoma
Hillary VP	Ex-Bill
YPO	US
Hyperloop Technologies	Nevada
Mitt Romney	Jeb Bush|Trump
Raghuram Rajan	CNBC
KKR Singapore	Kravis
Redstone	Viacom|CBS
Romney	Trump|Obama|Clinton|Pentagon|GOP|William Kristol
Bullard	Fed|St Louis Fed|Buiter|Harker
Pabst	Snoop Dogg
Pena Nieto	Trudeau|Pemex|Obama
Southwestern Energy	Armour
Fukushima	Japan|U.S.|Naoto Kan|Akiko Fujita
Hamm	Oklahoma
Suntory	Japan|Shinji Fukuyo
Schiffman	IAC
Axel Weber	Europe|European Central Bank|UBS
Mississippi	GOP|Trump|Clinton|Michigan|U.S.|Idaho
Prada	China
Wyoming	Arch Coal
VFC	TYC|DAL|MCO|TIVO
Rio de Janeiro	Brazil
Ayotte	Ball?
Hollywood Glamour	Violet Grey
Nyquist	Kentucky Derby
Apple Music	Deezer
Waxman	Gilead
Dolan	Comcast|Thomas|TWC
Saudi Arabia	Iran|OPEC|Russia|US|Congress|Cramer|SABIC|Bahrain|Obama|Canada|China|France|UK|IEA|Moody
Dilma Roussef	Brazil
Verizon	AOL|Yahoo|Armstrong|Vodafone|Motorola|Google|Vietnam|NYSE|John Legere|Verizon Wireless|ESPN|Dish Network|AT&T|Mario Gabelli|Comcast
Couric	Palin
Lehman	Glencore
Emirati	Abramovich
James Patterson	US
Rick Santelli	Chicago Tea Party|Ben Bernanke
Medicare Advantage	Cigna
UNIQLO	Tadashi Yanai
WTO	Mexico|EU
Vista Equity	Bain
Ex-Bill	Hillary VP
U.S. Midwest	Ukraine
Modigliani	Christie|Liu Yiqian
Sen McCain	United Launch|Pentagon
Air Berlin	ST Microelectronics|Adidas
Faber	CNBC|Shari Redstone|BellSouth|Viacom|China|AT&T
Deutsche	Europe
BASF	Umicore|U.S.
HRL	KORS|TIF
TPP	Japan|Congress
Modelo Especial	Corona
Laffer	Bush|US|Obama
Manny Pacquiao	Nike
TRUMP	U.S.
Patti Domm	CNBC
Ron Klain	Obama
Teamsters	Treasury
Mendocino	California
Robert Durst	HBO
Rousseff	Brazil|Mercosur|Lula|Workers Party|Senate
STMicroelectronics	Carlo Ferro
Airbus	Boeing|China|U.S.|Germany|Airways|Obama|Ronaldo|Norway
New England Patriots	US
WFM	CPGX|VIAB|TIF
WFC	ACN|KBH|YHOO
Snyder	Flint|Germany|Michigan
NMBL	SPLS|SWHC|TSN|DSW
Barack	Buffett|Hillary
End Fannie Mae	GOP
Mandel	Senate|Ohio
Peru	Fujimori|World Bank|Europe|Votorantim|USDA|Bank|U.S.|Kuczynski|Latin America
Susan Li	CNBC|Justin Trudeau|CNBC Media Alert
12th congress	Community Party|Vietnam
Spielberg	DreamWorks
Anwar	Mahathir
Elizabeth	Obama
John Williams	Fed|CNBC|Steve Liesman|San Francisco Fed
Irving Picard	Scott Cohn|CNBC|David Sheehan
Stock Market	CNBC|CNBC U.S. Video News Clips|CNBC Europe Video News Clips|CNBC Asia Video News Clips|CNBC Top Video News Clips
RTN	STJ
Boockvar	Goldman
Immelt	GE|Boston
Idenix	Gilead|Merck
Sandoval	Supreme Court
Joe	America|Biden|Davos|Gene Sperling
Manchester	UK
US Energy Agency	US
Fastweb	Italy|Swisscom
DISCA	ABC
OXY	Occidental Petroleum Corp
Tepper	Ackman|SunEdison|Alibaba|Einhorn|Bass|China|Loeb|Ira Sohn
Samsung	Apple|US|China|Sony|Amazon|Smart TV|Cramer|Xiaomi|Singapore|Michael Bay|Microsoft|U.S.|Huawei|Lil Wayne|Google|Ericsson|Nokia|Facebook
Westpac	Australia
Lee Kuan Yew	Singapore
Alcoa	Intel|Cramer|Klaus Kleinfeld|CNBC
Babson	America
Felipe	Spain
Marco Rubio	GOP|CNBC|Jeb Bush|Ted Cruz|Ken Griffin|Larry Ellison
Belarus	Bank
American Airlines	T. Rowe
Moritz Kraemer	Standard & Poor|CNBC
TEL	IBM|AAPL|GE|NFLX
Air NZ	NZ|1-United Airlines
Stephen Curry	Golden State Warriors
Brasil	Brazil
Flipkart	India
NTT Data	Dell|Japan
East Asia	World Bank|TABLE-World Bank|Europe
South Africa	Coke|Barclays|ANC|Styldrift|Brazil|Africa
Travelers	Texas
Reed Hastings	Netflix
Dynegy	Illinois
Nebraska	Hillary Clinton|Keystone|Warren Buffett
Islamic State	US|Hilla|Istanbul|Turkey|Paris
Hungary	US|Slovenia|Croatia
Jaitley	China|India
Brazil	Rousseff|Brasil|BHP|China|Meirelles|Vale|Lula|Mexico|Experian|Kroton|Rio?|Middle|Zika|GIC|Neves|Mantega|Moody|Arminio Fraga|India|Cargill|Workers Party|Xiaomi|Novogratz|Dilma Rousseff|South Africa|AB InBev|Facebook|Morgan Stanley|Bush|HSBC|Dilma Roussef|Fed|Dilma|Rio de Janeiro|Senate|Hunan Dakang
FDA	Medtronic|Zimmer|Sarepta|Takeda|U.S.|Lundbeck|Fat Advisory Committee|Holmes|Duchenne Muscular Dystrophy|Chiasma|Hospira|White House|WSJ|PTC
Stephen Hester	CNBC
SAB Europe	EU
ISS	NYSE
Ortiz	Red Sox
Jon Stewart	Sebelius
Huayi Brothers	Hollywood
Annual Stock Gifts to Charity	Warren Buffett
Mark Hoffman	Haines|CNBC
Hertz	Loeb|Shell|Icahn|Lyft|Cramer
Reckson	Icahn
ISM	Census Bureau
Syria	Obama|Russia|US|Putin|U.S.|EU|Congress|Turkey|Ukraine|Fuchs|Europe|Dubai|Merkel|Jordan|Aleppo|Germany
Lance Armstrong	DOJ|US
Hollywood	China|Google|Paris|White House|Netflix|Huayi Brothers|Silicon Valley|Dalian Wanda|NASA|ISIS|America
Syrian Electronic Army	Skype
J&J	Astra|US|GSK
Sa Sa	Hong Kong
Anbang	Marriott|Starwood Hotels
Stefan L?	CNBC
Wharton	Trump
SEC	U.S.|CNBC|NYSE|Steve Cohen|China|Vermont|Nasdaq|Stein|Cooperman|Apple|Credit Suisse|Ackman|White|Tobin Smith|Gasparino|Cramer|Miami|Madoff|Valeant|San Francisco|Congress|N.Y.|IBM|Barclays|Allergan|Homex|London|NY|Williams|AIG
Statistics Bureau	China
Katsuyama	O'Brien
DEALTALK-China Inc	Hong Kong
Carsten Kenteger	CNBC
Julie Taymor	Broadway Producers
Oncor	Energy Future Holdings
Buster	Chuck E. Cheese|Dave
Britney	Taylor Swift|Bratz
IMF	CNBC|China|Greece|Christine Lagarde|World Bank|Lagarde|Russia|Latin America|Sara Eisen|Mozambique|Ukraine|EU|US|Sri Lanka|MOZAMBIQUE|Gulf|OECD|Fed|Venezuela|Lipsky|EU Chooses France|Ecuador|Malaysia|UAE|UK|Jim Yong Kim|Rato|US Fed|NPL|UN|BOJ
Patrick	Massachusetts|Bain Capital
LA Clippers	Steve Ballmer
HK IPO	China
Marcato	Sotheby
NBC	Clinton|NFL|Oregon|Trump|Warren Buffett|Rubio|CBS|Millennials|Tom Brokaw
IMS	BIIB|CVS
Lyft	Austin|Hertz|Japan|Shell|Didi Kuaidi
Alexey Kornya	MTS
Rizwan Farook	Tashfeen Malik|San Bernardino
CITIC	Caijing
Shinseki	Senate
Mike Pearson	Bill Ackman
Carney	UK|England|EU
Yuan	Zhou|PBOC
Najib Razak	Malaysia|Sarawak|US
Jessye Norman	CNBC|US|Hillary Clinton
Adyen	Facebook
Jerry Hall	Rupert Murdoch|London
FAO Schwarz	Times Square
Sears	Wal-Mart|Kmart
Alaska Air	Virgin America|David Cush|Brad Tilden|JetBlue|CNBC
DeWalt	Mandia
Nicaragua	Panama Canal
Yankee	Derek Jeter
Beijing?	China
Financial News Channel	CNBC
Suhail Mohamed Faraj Al Mazrouei	CNBC
DG	MTN
Mossack Fonseca	Panama
DC	Mattel|Jeff Bezos|Obama|Janet Yellen
Darrell Read	ICAP|Libor|London
Homex	SEC
Alan Blinder	Former Fed
HB2 North Carolina	BofA|Moynihan
Jenkins	Barclays
INTC	YHOO|GE|GPN|NLSN
Ex-Democratic	Bernie Sanders
Peter Hancock	AIG|CNBC|Bob Benmosche
Venezuela	Switzerland|IMF|Moody|OPEC|Chavez|China|Beijing|Congress|World Bank|Cuba|ConocoPhillips
Mobvoi	China?|Google
Idaho	Utah|Arizona|Clinton|GOP|Mississippi|Trump|Michigan
Morici	Japan
Miami-Dade County	Carlos Gimenez|CNBC|Melissa Lee
Aliyun	New Singapore|Alibaba
Danoff	Fidelity
Stock Market Gains a Fed	Peter Schiff
NNPC	Nigeria
ATVI	HON|GPRO|WYNN
Justice Dept.	Cramer
Halo	Stryker|U.S.
MLB	Periscope|Meerkat|Rob Manfred|Apple
DHL	Asia Pacific|Salesforce
DHI	UA|GM
Gene Sperling	Joe
Bunny Ranch	US Senate|Dennis Hof
GoGold	Mexico
KKR	Yum|China
Martin Gilbert	CNBC
Paul Allen	US Supreme Court
GOP	Trump|Obama|Donald Trump|Paul Ryan|Clinton|US|Russia|Christie|China|Iowa|Huckabee|Chris Christie|House|CNBC|Donald Trump?|Jeb Bush|Rubio|Carson|Marco Rubio|Kasich|Hillary|Castro?|Ron Paul|Busch|White House|Idaho|Rick Perry|Scott Walker|End Fannie Mae|Conn.|Michigan|Tea Party|Silicon Valley?|Langone|New Hampshire|John Kasich|Donald Trump??|Romney|Cuba|Hillary Clinton|Wisconsin|Chicago|McCarthy|Walker|Mississippi|Cruz|Senate|Ted Cruz|Apple|Appointing Lew Treasury|Everson|Boulder|Obamacare|NBC-WSJ|Donald|O'Malley|Boehner|Cantor|Hillary Clinton?|Bush
Jane Birkin	Hermes
Trump University	Trump
Spitzer	Snooki
Tiki Barber	Digital Music Group Teams Up With YouTube
Eastern Europe	Silicon Valley
S&P Cuts Fannie	Moody 's Backs US 's AAA Rating
London?	Trump
Donald Trump??	New York|GOP
Goldberg	Disney
Lundbeck	FDA|Takeda
Chen	BlackBerry Messenger
Jonathan Gray	David Faber Interviews Blackstone|CNBC
Rosneft	Russia
Humana	Aetna|Centene
Bernie Sanders?	Jamie Dimon
Matthias Mueller	Volkswagen
Broncos	Cam Newton|Cowboys|NFL
Sean Parnell	Alaska
Nicki Minaj	Lin-Manuel Miranda|Leonardo DiCaprio
Barra	GM|US|Xiaomi
Reuters	HSBC|Red Bull|US|Hong Kong
HBOS	Bank
English Premier League	Manchester United|China|Deloitte
Derek Jeter	Yankee
Deloitte	English Premier League|Asia
Bundesbank	ECB
Chesapeake Energy	Carl Icahn|DOJ
Mario Draghi	ECB|Ben Bernanke|Cramer|Janet Yellen|Jim O'Neill
Robert Herjavec	Shark Tank
Golden State Warriors	Stephen Curry
Glade Brook	Alibaba
Jimmy Wales	Wikipedia
Greece?	Grimbo|Bitcoin
Percassi	Milan|Starbucks|Italy
Top Travel	CNBC|Changi Airport Group?|Lee Seow Hiang
Ex-Arkansas	Huckabee|White House
Hulu	Netflix|Rob Lowe|Disney|Fox|Epix
Hancock Gourmet Lobster Co.	Auntie Anne
Steve Liesman	CNBC|Stanley Fischer|San Francisco Fed|Dallas Fed|Rob Kaplan|John Williams|CNBC Fed|Federal Reserve|Trump|Clinton|Federal Reserve Bank of Atlanta|Federal Reserve Bank of Chicago|Dennis Lockhart|Charles Evans
Fisher	FOMC|Fed
Loretta Mester	Fed
North Africa	Middle East
Charlie Hebdo	eBay
HAL	AMGN|CVS|AMC|BLL|UAL|LH
L'Oreal	Nestle
J.P. Morgan	Kelly
John Skipper	ESPN
Joan Weill	Sandy
Red Bull	Reuters
Cohn	Dalio|Davos|US
Instagram	Facebook|Laremy Tunsil
Becky Quick	CNBC|Warren Buffett
Fiorina	Trump|Clinton
European Commissioner for Economic & Financial Affairs	Pierre Moscovici|CNBC
Sec Lew	China
Apple Inc	AAPL
Dennis Lockhart	Steve Liesman|Federal Reserve Bank of Atlanta|CNBC
Darden Restaurants	Olive Garden
Howard Cement Alliance	APEC|Bush
Kentucky Derby	Nyquist
EMC	LVS|Dell|TSLA|CMG|LULU|NFLX
Chanos	China|Bass|Dell|Einhorn
Hillary Clinton?	FBI|GOP|Ted Cruz
Southern Europe	France?
White House Causes Stocks to Briefly Plunge	AP
Ashton Carter	Obama
Hamptons	Beverly Hills
General Electric Co	GE
Lauder	Michael Kors
Martoma	SAC|FBI
Thatcher	Cherie Blair|Tony|Boris Johnson
Supreme Court Tibble	Edison
Schaeuble	Germany|Lagarde
Brunswick	Skyworks
Iowa	Trump|Clinton|GOP|Sanders|Hillary Clinton|Google|Christie|Texas|Bernie Sanders|New Hampshire|Cruz
Edina Hong	Singapore|Emmanuel Stroobant
Univision	ABC
University of Chicago Booth School of Business	CNBC|Austan Goolsbee
Nouriel Roubini	Peter Schiff|Italy
Cruz-Kasich	Howard Dean|Bernie|Hillary
Berlin	Welt
Eddie Vedder	Madison Square Garden|Bon Jovi|Dave Grohl
CIT	CIT Group Inc
Napster	AOL
Allergan	Pfizer|Cramer|Paulson|CNBC|EU|US|Santoli|Brent Saunders|Ackman|SEC|Sass|U.S.|Teva|Tesla|Clinton|Disney
Ravens	Ray Rice
Jeff Gundlach	Bill Gross|Donald Trump
Hatzius	Goldman
Dennis Gartman	Peter Schiff|Canada|Japan|Fed
Johnson	Dwayne
U.S.	China|Fed|CNBC|Obama|Iran|Europe|Supreme Court|Federal Budget|Trump|Amazon|House|Argentina|BlackRock|SEC|Biden|U.N.|Daimler|Sandy|WPP|Puerto Rico|Warren Buffett|Senate|Zika|BP|Congress|Korea|OPEC|Terex|GMO|UBS|Syria|Canada|Volkswagen|Sarepta|Jordan|Apple|Japan|Takata|EU|Paulson|ANTONIN SCALIA|SAMSUNG ELECTRONICS CO LTD|Medicare Advantage 2017|Kuwait|Epic Systems|Maryland|Pakistan|Samarco|News Corp|FBI|Harold Hamm|North Korea|USDA|Yellen|Pioneer|Kaesong|Ukraine|Mercedes|Lauren Bush Lauren|Acadia|Citibank|Wells Fargo|Balboa Bank & Trust|Hill|Warren|KASHKARI|Priceline.com|Cohen|Pentagon|Lumileds|Middle East|Tennessee|Quest Diagnostics|Airbus|London|Bridgewater|Mills|Morgan Stanley|California|HARRY REID|Doha|Wal-Mart|FDA|Treasury|BOJ|Flint|Time Warner|Norfolk Southern|Sprint|Carfax|VW|Dudley|Seattle|Greenspan|Halo|Britain|Samsung|Colorado|Orbital|Philips|Supreme Leader|Asia Infrastructure Investment Bank|Macau|Paris|FCC|Kevin Brady|OBAMA|Bill Gates|R.J. Reynolds|EXCLUSIVE-China|Mississippi|Ford|Dalio|ALASKA AIR GROUP INC|Disney|Greece|MSNBC|Netflix|Stein|Lufthansa|Scalia|Allergan|Chicken McNuggets|Hatch|HSBC|Ironwood|Spain|Huawei|TRUMP|Adelson|Diagnostics|Steven Cohen|SCALIA|Tubman|America|Singapore|Quintanilla|Medtronic|BMW|Egypt|Iraq|EPA|john stumpf|New York|US|Sanders|BASF|MGM|Umicore|NOAA|Washington|Brexit|George W. Bush|Las Vegas Sands|Russia|SAP|Reid|CNBC Digital Video|Buffett|Texas|Stryker|VIRGIN AMERICA|Juniper|Edison International|Fukushima|UK|Peru|Google
United Continental	Oscar Munoz|Jeff Smisek
Laremy Tunsil	Instagram
IRELAND	DUBLIN|MOODY 'S
Freddie Mac	Fannie Mae
Skechers	Cramer|Amazon
ULTA	CBS|AZN
Berkshire Feels	Buffett
Marijuana Inc	America
Dunkin	McDonald|Starbucks
Northrop	McCain|U.S. Air Force|EADS
Sheldon Adelson	Nevada
Lagunitas	California
Malaysia	Najib|Abu Dhabi|IPIC|Singapore|Najib Razak|Muhammad Ibrahim|Narendra Modi|Seychelles|Greece|ASEAN|Parliament|Indonesia|IMF|Southeast Asia|US|Borneo
Community Party	12th congress|Vietnam
Carvel	Jimmy John
Primark	US
Ash Carter	US|China|Asia
Tim Sloan	Wells Fargo
Michelin	London|Mexico
Jim Yong Kim Speaks	Sara Eisen|CNBC
Martin Sorrell	WPP|CNBC
Sachs	Justice Dept|Blankfein
Bill Ackman	CNBC|Pershing Square|Carl Icahn|Mike Pearson|Herbalife|Bausch & Lomb?|Scott Wapner|JC Penney|Bausch & Lomb|JCP|CNBC Media Alert|Bloomberg
Aleppo	Syria
Songbird	Canary Wharf
Markets Right Now	China
Stonington	Conn.
MetLife	US|Mass Mutual Life Insurance|AIG
Jes Staley	Barclays|CNBC
Los Angeles Lakers	NBA|Kobe Bryant
Calif.	Brown|Santa Barbara|Brentwood|Encino|Feinstein
CNBC World Television Network	Global Financial Markets|Europe|Asia
FINRA	Wedbush Securities
Auntie Anne	Hancock Gourmet Lobster Co.
Weidmann	ECB|Draghi
Harris	US
John Cahill	Kraft Foods
Labour	Khan|Britain|London
Bud	America
Security Council	North Korea
Philip Kives	K-tel
Jokowi	Europe
Hamburg	Songdo
Steve Jobs	Cook|Michael Fassbender|Apple|eBay
Bill Gross	Pimco|Fed|Jeff Gundlach|Janus|US
Air France KLM	Paris
PEPFAR	Elton John AIDS Foundation
Sibanye Gold	Africa|AMCU
Kia Motors	Mexico
Virgin	Branson Dons|United|Weibo|Branson|China
Tesla	Apple|Elon Musk|Cramer|Jim Chanos|China|Musk|Etsy|Hyperloop|SpaceX|Disney|Goldman|Audi|Herbalife|Jaguar|NJ Assembly|Gundlach|Porsche|Steve Wozniak|Allergan|Kraft Heinz|AutoNation|Nevada|T Rowe Price|Tesla Energy
Neel Kashkari	CNBC|Federal Reserve Bank of Minneapolis|CNBC Media Alert
UFC	MMA|Dalian Wanda|Blackstone|Conor McGregor
Reagan	Clinton|Steve Forbes
Robert Gates	Obama
Canary Wharf	Songbird
Fujimori	Peru
Tata Steel UK	Liberty House|UK|House
Timo Weiland	Deutsche Bank
Bill Gates	Warren Buffett|Microsoft|Jamie Dimon|George Soros|Pharrell|Facebook|U.S.|FBI|Panama|Jimmy Fallon
Jessica Alba	LeBron James
Lawrence A Rosen	Deutsche Post DHL
Fiji	Greenland
FACTBOX-Berkshire Hathaway	Warren Buffett
Najib	Malaysia|Borneo
Nick Hawkins	IAG
US News & World Report	Harvard
Sudan	EU
Sandy Weill	Citigroup|CNBC
Brian Sullivan	Nigeria
Dick	Sports Authority|Nike|Academy Sports eye Sports Authority
Jimmy Lee	Yogi Berra
Wikipedia	Jimmy Wales|US|Facebook
Donald Sterling	NBA|Clippers
Monti	Italy
Societe Generale	Asia
New York Mike Bloomberg Sits Down	CNBC|Bob Pisani
New Singapore	Aliyun|Alibaba
AIG	Peter Hancock|Supreme Court|NFLX|Bernanke|CBS|MetLife|China|GE|Anadarko|BA|SEC|AAPL|WYNN|ITT|YHOO|Madoff|JCP|Bob Benmosche|Bank of America|TIF|BHI|Wal-Mart|CNBC
Icahn Talks Dell	Diller|Lew
Ex-Obama	Austan Goolsbee|Fed
BAE	Lagardere|EADS
Israel	Gaza|US|FAA|Trump|Cairo|UOB|Iran|Biden|West Bank|Singapore|Hamas|Silicon Valley|Netanyahu
Karen Finerman	Suze Orman
NSA	Google|US|Microsoft|Yahoo|Government Communitcations Headquarters|Cisco|Obama|Brin|Snowden|Washington
Citibank	U.S.
Freddie	Government Capital Bail Out Fannie|Fannie
New Hampshire	Trump|Obama Jumps Into|Hillary Clinton|GOP|Bernie Sanders|Iowa
Bloomberg	Bill Ackman|Ackman|Hillary|NYC|Clinton
BlackRock	U.S.|China|Kapito|Fed|Larry Fink|Japan|Peter Fisher|CNBC|Fink|Icahn
Deutsche Bank	China|N Carolina|Timo Weiland|Toyota
Hey Ginni Rometty	Cramer
Phil LeBeau	CNBC|Detroit Auto Show Today|Ford
Centene	Aetna|Humana
DBS Bank	Sok Hui Chng
IRS	Yahoo|Carl Gaimari|AP|Delphi Automotive|Bernstein|Russia|Senate|Martin Shkreli
Toyota	Lentz|Dell|Google|GE|Abercrombie|Ford|Madoff|VW|Deutsche Bank|Apple
McCain	Obama|Intrade|Palin|Northrop|Sarah Palin
ESPN Analyst	Curt Schilling
Rakuten	Viber Media|Japan|Azimo
Ferarri	Milan
Diagnostics	U.S.
IRA	Cramer|Obama?
BNP Paribas	Lars Machenil
John Cochrane	Fed
O'Neill	Goldman|USA
Social Security	US
BNSF	Warren Buffett|Berkshire
Whiting	Kodiak
Amazon	Google|Netflix|Jeff Bezos|Microsoft|Apple|Bezos|Alibaba|U.S.|China|eBay|Alexa|Oasis|Wal-Mart|FTC|Roku|Microsoft & Alphabet|Hedgie Palihapitiya|Cramer|Meeks|Samsung|Spotify|California|Colorado|Kindle Oasis|Costco|Sam|Groupon|Skechers|Atlas Air|Low-Tech Warren Buffett|Woody Allen|UPS|Gilead|LinkedIn|London|Facebook|Jim Cramer|Etsy|Loft
L Brands	Victoria|Kraft
Rio?	Brazil
David Faber	CNBC|Blackstone|Hayman Capital Management Managing Partner Kyle Bass Speak|Jeff Smith|Steve Schwarzman
Tracy Morgan	Senate
Yildiz	Mustafa Tercan
Viber Media	Japan|Rakuten
Williston	North Dakota|Bakken
Kim Jong	Arianna Huffington|Trump|N Korea
White House	Obamacare|Obama|Orszag|Fed|ISIS|Ex-Arkansas|Pope|North Korea|US|Supreme Court|Deese|Karl Rove|Congress|Citi|UnitedHealth|Beijing|Senate|Puerto Rico|California|CDC|FDA|GOP|Silicon Valley|Treasury|Pataki|Mike Bloomberg|Huckabee|Hollywood|Scotland|State House
EFG-Hermes	Sawiris
HBO	ESPN|Showtime|Time Warner|EchoStar|Robert Durst|Apple|Canelo
United	Oscar Munoz|Virgin|Gaal|Cuba
CNBC International	CNBC Catalyst
Minn.	TurboTax
Conservative	UK
TIVO	MCO|DAL|VFC|TYC
BOJ	Asia|Fed|US|China|Apple|Japan|Icahn|Kuroda|NPC|CNBC|U.S.|Europe|IMF|FOMC|St|Abe|Facebook
Gabelli	Iraq
Comcast	AT&T|TWC|T-Mobile|Yahoo|FCC|DreamWorks|DreamWorks Animation|Verizon|Netflix|Ralph Roberts|Apple|Time Warner Cable|Dolan
Buffalo Wild Wings	Jim Cramer
Gotham City	MDC
LVMH	France|Asia
EPA	VW|Murray Energy|U.S.|US|Supreme Court|Flint|Obama
Hilcorp	Ohio
ALASKA AIR GROUP INC	VIRGIN AMERICA|U.S.
Domm	CNBC|Fed
Mark Cuban	Dallas Mavericks
Corbat	Citi
Kyle Bass	China|Japan|US|Li Daokui
Cell Power Plant for Data Center Project With Microsoft Corporation	FuelCell Energy
DIRECTV	AT&T
Getty	Google
Guinea	World Health Organisation
Guantanamo Bay	Congress|Obama
Steve Forbes	Reagan|Trump VP
Hans Vestberg	CNBC
Miss.	Medicaid
Citadel Capital	Uganda|Egypt
FIFA	Sepp Blatter|Blatter|Qatar
Guptas	Africa
Brad Tilden	Virgin America|David Cush|Alaska Air|CNBC
Strauss-Kahn	Putin Hints|Britain|France
BRKB	TEVA|TSN|HCP
SVU	MMM|WHR
European Union	Soros|Margrethe Vestager|CNBC Media Alert|CNBC
U.N.	U.S.|Libya|Iran|China
Shari	Viacom
Wynn	Wynn Resorts|Showtime
Selfie	LG
Air Force	Pratt
Blatter	Japan|FIFA
Long Beach	West Coast|Los Angeles
London	New York|Hong Kong|UK|Kerry|Loft|Labour|Labou|Panama|NFL|Libor|Saudi Aramco|Michelin|Middle East|SEC|Amazon|Margaret Thatcher?|Donald Trump|Rupert Murdoch|China|Brexit|StanChart Iran|Darrell Read|Jerry Hall|Potter|ICAP|J.K. Rowling|Sadiq Khan|Obama|U.S.|Khan|Iran
Bloomindale	Starbucks
Sharp	Foxconn
Suntrust	Zillow
Keith Weed	CNBC|CMO
New Mexico	VW|Ackman
Lil Wayne	Samsung
Cheniere	Carl Icahn|Charif Souki|US
non-OPEC	OPEC|Moscow|El-Badri
Army	Ukraine|Russia
West	Russia|ISIS|Putin
Sin City	Las Vegas
Fed Chair Yellen	Obama
Herbalife	FTC|Ackman|Etsy|Bill Ackman|Activision|Square|Tesla|Icahn|Endo
Somalia	Libya|Yemen
Mars	NASA|Matt Damon
CMA CGM	MSC|Maersk
Mark Pincus	Zynga
Symantec	Brown
Brentwood	Calif.
SCALIA	OBAMA|MSNBC|U.S.|HARRY REID
Bain Capital	Massachusetts|Patrick|Asia
T-Mobile	AT&T|Sprint|Comcast|Google|FCC|Las Vegas|Sony|John Legere
Census Bureau	ISM
UB Group	Vijay Mallya|India|Kingfisher
Daimler	U.S.|Volvo|Mercedes-Benz|Mercedes
Lenovo	India|Wong Wai Ming|Intel|Microsoft|Dell|China
Mark Mobius	Templeton
Arne Sorenson	CNBC|Marriott International
Duterte	Philippines
Sok Hui Chng	DBS Bank
NKorea	US|China
Vietnam	China|Philippines|NYSE|Verizon|12th congress|South China Sea|US|Casino|Community Party|Thailand
Rogoff	US
Cilnton	Trump
Dre	Apple|Iovine
Busch	GOP|Chicago
Electric	California
Upper House	Datai|Lombok Lodge|Asia
HTC	Huawei|Facebook
Reebonz	Singapore
Giorgi Kvirikashvili	CNBC
DUBLIN	FRANKFURT|MOODY 'S|PARIS|IRELAND|NEW YORK
Syngenta	Univar|Monsanto|Fyrwald|John Ramsay|Bayer
Steve Wozniak	Apple|Tesla
Mozambique	IMF|Russia
Chevron	Exxon|Nigeria
Wynn Resorts	Wynn
West Coast	East Coast|Madison Square Garden|Los Angeles|Long Beach|California
Harmit Singh	Levi Strauss & Co.
Hollande	FED|Russia|Putin|France
Odell Beckham Jr	Buick
Smart TV	Samsung
Xiaomi	China|Apple|India|Huawei|US|Barra|Modi|Samsung|Ericsson|Brazil|FDI
Credit Suisse	UK|Thiam|Fed|HSBC|Europe|SEC|Panama|Barclays|NY|CNBC
Mester	Fed|US
Pickens Group	Navistar
Fuller House	Netflix
Janet Yellen	Fedmas|Fed|John Boehner|Mario Draghi|DC|ECB|Cramer|Pimco
Baidu	Alibaba|Google|MSCI|China
Bank of England	Mark Carney|European Central Bank
Flagstar	NY
Adelson	Macau|Trump|U.S.|Las Vegas Sands|Rubio|Gates|US|Buffett
Wachovia	Microsoft
Erin Callan	CNBC|Lehman Brothers|CNBC Media Alert
Hotel	CNBC Europe|Africa|Middle East
Toshiba	Japan
China Inc	Asia
NY	Barclays|Credit Suisse|SEC|Flagstar
NZ	Asia|Panama|Air NZ|Sky City|China|Knight Frank|1-United Airlines|Australia
Andy Murray	Armour
Jimmy Fallon	Bill Gates
Government Communitcations Headquarters	NSA
Assad	Iceland|Putin|Panama
SPDR Gold Trust	Paulson
Obama	GOP|Syria|Congress|US|U.S.|EU|Trump|McCain|Fed|Clinton|Biden|Keystone|Iran|ISIS|Fed Chair Yellen|Sony|Scalia|Bush|Supreme Court|U.S. Senate|House|Senate|Flint|Romney|UK|Kudlow|White House|Merkel|Goldman|Ben Bernanke|Intrade|Saudi Arabia|Ryan|DC|Yahoo|Buffett|Summers|Cramer|Libya|Palin|Foley|Ronaldo|S&P|Hagel|China|Caterpillar|Name Lew Treasury|Cuba|FCC|CNBC|Sylvia Burwell|France|Cantor|Iraq|London|McConnell|Ashton Carter|Wall St.|Reid|Chadwick|Bieber|EPA|Cameron|Germany|Robert Gates|Appointing Lew Treasury|Treasury|Yellen|Warren Buffett|Elizabeth|Huckabee|Pope|North Korea|Trudeau|Ron Klain|Guantanamo Bay|Russia|Edwards|Laffer|Pena Nieto|Putin|Cruz|Argentina|Texas|Rubio|NBC-WSJ|Ukraine|Airbus|NSA
VIRGIN AMERICA	ALASKA AIR GROUP INC|U.S.
Reserve Bank of Australia	China
Taco Bell	US
Manuel Caldeira Cabral	CNBC
George Osborne	CNBC
Walker	Huckabee|GOP
Yannick Bollor?	CNBC|Havas
Miliband	UK|Cameron
Morgan Stanley APAC	China
Chadwick	Washington|Federal Reserve|Congress|Obama
Timmer	Fidelity
House	Senate|U.S.|Paul Ryan|Obama|Puerto Rico|GOP|McCarthy|Schwarzenegger|US|America|John McAfee|Chris Christie|Tata Steel UK|Hill|Hastert|U.S. Supreme Court|Boehner|Ryan|Trump|Issa|Hatch
Federal Reserve Bank of Minneapolis	Neel Kashkari|CNBC|CNBC Media Alert
Kraft Heinz	Tesla
US Treasury	ECB|Lew|Fed
Gulf of Mexico	US|BP
FBI	Apple|San Bernardino|Shkreli|US|Tim Cook|Iran|SAC|Syed Farook|ISIS|U.S.|VW|Oregon|Justice Department|Martoma|Hillary Clinton?|Google|John McAfee|Bill Gates|Wu Tang|Fmr CIA|Calif
Cushing	Oklahoma
Duke of York	CNBC
John Rogers	J Sainsbury
Peter Schiff	Marc Faber|Nouriel Roubini|Doomsayers Nouriel Roubini|Fed|Goldman Sachs|Dennis Gartman|Euro Pacific Capital|Mark Dow|Stock Market Gains a Fed
California Chrome	Belmont Stakes
USA	Rubin|O'Neill|US|Geithner|Paulson|Goldman|Waterloo|American Apparel|Wisconsin|Wal-Mart
AZO	CS|NKE
Rubin Warn	Paulson
Foxconn	Sharp|Apple
LinkedIn	Gilead|Amazon|Jeff Weiner
Hutch	India|Vodafone
Shizuishan	Shaanxi|Qinghai
John Sculley	Apple
Alan Simpson	Grover Norquist
Sarawak	Najib Razak
Martin Shkreli	IRS|Ghostface Killah
Garland	McConnell|Senate
Tory	UK
Hyundai	Google
Alibaba	China|Jack Ma|Yahoo|US|Baidu|Amazon|Loeb|Europe|Western Union|Cramer|Jim Chanos|Aliyun|Paulson|Charles Chao|YouTube|Aladdin|Coleman|Glade Brook|Apple|Sony Pictures|AC Milan|Sina|Best Buy|Gucci|Tepper|Weibo|Halvorsen|China Telecom|Tmall|MSCI|Ant Financial|Mayer|New Singapore
Ankara	Turkey|Moscow|PKK|Russia|Iraq
Najarian	Facebook|Buy Wendy|Microsoft
CNBC Top Video News Clips	Stock Market
Prancercise	Josh Brown
Grolsch	A.B. InBev
Palin	Ryan|Obama|Couric|McCain|Trump
Valeant Pharmaceuticals	Munger
Ross	TJX
Darty	Steinhoff|Africa
Court OKs Corp.	Arizona
Peter L. Briger Jr.	Advisory Board
Airbus - Tasnim	Iran
Jaguar	Porsche|Tesla
Omaha	Warren Buffett|Charlie Munger|Berkshire|Loeb
Pharrell	George Soros|Bill Gates
Trump Organization	Donald Trump|CNBC|Republican Presidential Candidate
ICA	EXCLUSIVE-Mexico
Andy Grove	Silicon Valley
Brian Krzanich	CNBC|Intel
Lombok Lodge	Asia|Upper House|Datai
Minsk	Poroshenko|Russia|Putin|Ukraine
Boston Beer Co.	Jim Koch
Sandberg	Facebook|Ebersman
John Legere	AT&T|Verizon|T-Mobile
Myanmar	China|Imphal|India|Mr Clean|Yoma
Qinghai	Shizuishan|Shaanxi
Frans van Houten	CNBC
Pablo	Jay Z|Kanye West
Regions Top Travel	CNBC
PNRA	AAPL|IBM|LLY|UNH|EBAY
Canada	US|Libya|Alberta|U.S.|Dennis Gartman|Fort Mac|Zinifex|Goldman Sachs|Saudi Arabia|Europe|Australia|Nigeria|Fed|World Bank|Montreal
Edison	Supreme Court Tibble
El-Badri	non-OPEC|OPEC
ESPN	Disney|Borland|John Skipper|Verizon|Netflix|HBO|T-Mobile Will Let Customers Stream HBO|Apple|Activision
Billionaire Steyer	Kochs|Rubio
Obamacare	White House|GOP|Larry Summers|HealthNet|CBO|Aetna|Gallup|Fed
Supreme Court	U.S.|Obama|Madoff|EPA|Deese|AIG|White House|Scalia|Wal-Mart|Seattle|Sandoval|POM
Madison Square Garden	Dave Grohl|Eddie Vedder|Bon Jovi|West Coast
IRAN	UAE|OPEC|IRAQ
Kaplan	Fed|US
Schmidt	Google|Pentagon|Tim Cook
Asahi	Anheuser-Busch InBev|SAB
Brown	Charles H. Blood|Symantec|Iran|Calif.|Trichet|Pimco|California|Milken|UK
Lipsky	IMF
Virgin America	Alaska Air|David Cush|CNBC|Brad Tilden|JetBlue|Richard Branson
Rent-a-Suitcase	Hong Kong
NCAA	Moglia|UCLA|Apple
Garuda	Qatar
Grover Norquist	Trump|Alan Simpson
Carlyle Group	Johnson & Johnson|David Rubenstein
Don Draper	Google
Kashagan	ConocoPhillips
Supreme Court?	Scalia
China Reinsurance	Hong Kong|China Huarong AM
BOJA	HIBB|GCO
Bushnell	Atari
Tea Party	GOP|McCarthy
Radisson	HNA|China
Olive Garden	Darden Restaurants
Alaska	Washington|Walker?|Sean Parnell|Detroit
Jimmy John	Carvel
GIC	Brazil|India
Phil Knight	Nike|Sara Eisen|CNBC Media Alert|CNBC
John Stumpf	US|Wells Fargo
AMZN	TSN|YHOO
S&P Dow Jones	China|Howard Silverblatt
Herman Gref	CNBC
NPL	China|IMF
Beethoven	Mozart
Ridley Scott	UAE
Macau	Las Vegas Sands|China|U.S.|Adelson
Wolters Kluwer	Kevin Entricken
Gates Foundation	Hadley Gamble Speaks|CNBC
Bonnie	Clyde
NPC	China|Asia|US|Fed|Beijing|Japan|BOJ
Scott Wapner	Bill Ackman|CNBC|Bausch & Lomb
Samsung?	China
SolarWorld	China
MENA	Abu Dhabi|Dubai
TSN	SPLS|NMBL|SWHC|YHOO|DSW|TEVA|HCP|BRKB|AMZN
Rand Paul	Yellen|Fed
Durant	Westbrook
Pearl Harbor	US
Best Buy	Alibaba
Nomura	ING|Barclays|ANZ|China|Goldman
Kensho	Fed
Naftogaz	Gazprom
United Launch	Pentagon|Sen McCain
Kravis	KKR Singapore|Spain
James Bond	Sony
Denver	Seattle
Robo	Fidelity
Trump White House	US
East	Austria
Eivind Kallevik	Norsk Hydro
Giants	Facebook|China|Jonathan Tisch|Tisch
Uzbekistan	GM
KBH	WFC|YHOO|ACN
Korea	U.S.|Kaesong|Fed|Warren Buffett|Taiwan|Bill Richardson|Japan|Lotte Mart|China|Reckitt Benckiser
Teva Pharmaceutical Industries Ltd	TEVA
Mark Hurd	Larry Ellison
Marvell Technology	Carnegie Mellon
Alexis Horowitz-Burdick	Singapore|Luxola
Louis Dreyfus	Amaggi|HSBC
Pepsi	Coke|Nelson Peltz|Russia|Indra Nooyi
Hitachi	CNBC|ABLA|Asia|Nakanishi
SHAK	URBN|IBM
Kaesong	Korea|South Korea|U.S.
Epperson	OPEC|CNBC
Baker Hughes	Halliburton|US Justice Department
HCP	TEVA|BRKB|TSN
Microsoft & Alphabet	Amazon
Kingfisher	Vijay Mallya|UB Group|India
Steve Sedgwick	OPEC
US Senate	Dennis Hof|Bunny Ranch
National Football League	NFL
Dick Costolo	Cramer|Harvard Business
BLL	UAL|LH|HAL
Gap Inc	Navy|Sonia Syngal
Li Daokui	Kyle Bass
Watching USA	NYC|Belgium
Time Warner Cable	Comcast|FCC
Dole	US
Jack Lew	United States Treasury|CNBC|George III|Treasury|US Congress
Periscope	Meerkat|MLB
ConocoPhillips	Venezuela|Kashagan
Hugh Johnston	PepsiCo
Istanbul	Islamic State|Turkey
Nader	Sirius|Icahn
Cantor	Pelosi|Obama|Boehner|GOP
Famer Jerry Rice	NFL Hall
Netanyahu	Gaza|Israel
Tom	Jerry|Tate
Berkshire Board	Warren Buffett
Nigeria	Russia|Boko Haram|Doha|Canada|Chevron|US|Blackstone Africa|Brian Sullivan|NNPC
Johannes Chan	HKU
Europe	US|China|Asia|U.S.|Draghi|Fed|Brussels|Russia|Lew|Poland|ECB|Greece|Alibaba|Japan|UK|Google|CNBC|Pandora|GM|Credit Suisse|Seadrill|Beijing|HSBC|Latin America|EU|Iran|Romania|VW|Latvia|East Asia|Merck|Navy|Panama|John Paulson|Austria|France|Vince Farrell|Singapore|UBS|Glencore|Telecom Industry|Soros|Nissan|Cyber Santa Shines Light|Switzerland|EDF|Bitcoin|Allianz|Global Financial Markets|Merkel Obama|Merkel|Jokowi|ISIS|CNBC World Television Network|Syria|Axel Weber|Canada|Davos|Hong Kong|Australia|S&P|Japan?|Skype|Ukraine|Fink|Germany|Peru|North America|Doha|Fuchs|BMW|Deutsche|Publicis|Warren Buffett|BOJ
Siemens	IBM|China
Calacanis	Google
Sumatra Island	Indonesia
FCC	AT&T|Timer Warner Cable|Comcast|DirecTV|BellSouth|Netflix|Spain|T-Mobile|LightSquared|Obama|McDowell|NFL|Time Warner Cable|U.S.
Andrew Mackenzie	BHP
Kate Spade	North America
Low-Tech Warren Buffett	Amazon
Hong Kong	China|Snowden|Fed|Singapore|Asia|London|Baltics|China Reinsurance|Gucci|S&P|JPMorgan|HSBC|Li Ka-Shing|New York|John Greenwood|Goldman Sachs|Rent-a-Suitcase|China Huarong AM|India|Forbes Media|Europe|DEALTALK-China Inc|Occupy Central|Sa Sa|Saudi Aramco|Paris|Leung|Reuters
Redskins	NFL
Shanghai	Carrie Hammer|China|HSBC|Asia
Boeing	Airbus|Xerox|Fed|America|China|Chicago|Middle East|Iran|Illinois|Pfizer
Larry Page	Sergey Brin|Jeff Bezos|CNBC|Google
Sotheby	Marcato|Madison Square|Pink Star
FOMC	Fed|Asia|Crescenzi|Fisher|BOJ|US
Philippines	Duterte|Rodrigo Duterte|South China Sea|China|Asia|CNBC|Donald Trump|Vietnam|US|Hague
Satya Nadella	Microsoft
Joe Conforte	America
St	US|BOJ|Apple
CLSA	Trump
Zinifex	Canada
Jeremy Siegel	Fed
Red Sox	Ortiz
Notre Dame	Pope
William Shatner	California
Elop	Nokia|Microsoft
Adidas	Nike|Air Berlin|China|ST Microelectronics|IAAF
Electronic Arts &	Disney
Jesse Jackson	Steve Ballmer
Mideast	Dubai|Russia
Ed	New York
Omnicom	N.America
Seagate Technology	US
Inc	Amy|E.S. Kluft & Co|Brooklyn
Eurotunnel	Calais
IBM	Warren Buffett|Cramer|Apple|Groupon|NFLX|Siemens|Facebook|Netflix|Druckenmiller|Nasdaq|SHAK|Intel|PNRA|WSM|S&P|GE|URBN|Buffett|Watson|Ford|EBAY|CNBC|India|Bill Miller|Time|TEL|AAPL|SEC|UNH
Yale	Harvard|Ivy League
Ben Bernanke	Fed|Mario Draghi|CNBC|Obama|Rick Santelli|US
Nepal	Google|Facebook
Munger	Valeant Pharmaceuticals|Buffett|Gates|Berkshire
CNBC Sports	Asia
USDA	Peru|U.S.
MGM	U.S.
HealthNet	Obamacare
Calif	FBI
McCulley	Fed
Parliament	Malaysia|UK
David Einhorn	Keurig Green Mountain|Caterpillar
Zeckendorf	Manhattan
PGA	Hunter Mahan
Fed Ready	Bernanke
Says Banks Gain From Fed	Fed
Shun Facebook ` Drama	Twitter
Ted Cruz?	Carly Fiorina
CUDA	LMT
Obama Recovery	Brady
CBS Corporation	Leslie Moonves|CNBC|CNBC Media Alert
John Key	Wallabies|All Blacks
Arch Coal	Wyoming
Renault	France|China
Rodrigo Duterte	Philippines|Asia|Donald Trump
Tankan	US|China
Mattel	Barbie|Hasbro|SeaWorld Trainer Barbie|Cramer|DC
Kaminsky	Microsoft
Wilbur Ross	WL Ross & Co.|Carlyle|Doha|OPEC|Greece
LeEco	Apple|Jia Yueting
Kelly	J.P. Morgan
Viacom	Dauman|Redstone|Shari|Redstone Tells CNBC|Faber|Paramount|Shari Redstone|CNBC|US|Netflix|Disney|CBS|Paramount Studios|EXCLUSIVE-Investor Gabelli
Dow	S&P|DuPont|Fed|Yellen|Yahoo|Apple|Liveris|Nasdaq|US|Dan Loeb
CIT Group Inc	CIT
David Rubenstein	Carlyle Group
World Economic Forum	Davos|CNBC Launches Marketing Drive
Cinnabon	Kat Cole
Mexico	Trump|Ford|HSBC|US|Brazil|GoGold|Michelin|EU|New York|WTO|Kia Motors|Torex Gold|Nieto|America Movil|Donald Trump|Pemex|Lowe
Bob Diamond	George Soros
Montana	Big Sky Country
JFK	JetBlue
Rosengren	Fed
Hayman Capital Management Managing Partner Kyle Bass Speak	Steve Schwarzman|David Faber|CNBC|Blackstone
Illinois	Chicago|S&P|Boeing|Dynegy|Quinn
Nils S. Andersen	CNBC
Kostin	Goldman
Middle East	Africa|North Africa|CNBC Europe|Hotel|Suez Canal|U.S.|China|Boeing|London
Tino La Spina	Qantas
Pickens	Washington|CNBC|US
Edelman	Plotkin
MIT	Harvard
Texas	Bill|Perry|Oklahoma Brace For Round Two Of Hail|CNBC|America|U.S.|Ohio|Takata|Travelers|Houston|Zika|US|Medicaid|Iowa|Honda|Oklahoma|Obama|Silicon Valley
Videogame Company	Curt Schilling?
NSX	VMware
Stein	U.S.|SEC
Anadarko Petroleum Corp	APC
Chris Christie	GOP|Donald Trump|America|House
DaimlerChrysler	Bulgari|Ahold|UCB|Pearson
AOL	Verizon|Napster|Yahoo|Armstrong
Lululemon	Beyonce
Key Commodities	Bonds
Grimbo	Greece?
Tata Steel	UK
Brussels	Europe|Facebook|ISIS|US|Cuba|Belgium|Cramer|Kerry|Zika|New York|Metro|Marriott|Paris
MOODY 'S	DUBLIN|IRELAND
Oklahoma	Hamm|Texas|McClendon|Cushing
Moody	China|Russia|Bahrain|Gulf|Calpers|Draghi|Moscow|Saudi Arabia|Venezuela|US|Brazil
Buddhist	Japan
URBN	IBM|SHAK
R.J. Reynolds	U.S.
Fuchs	EU|Syria|Germany|Europe|Merkel
Trudeau	Pena Nieto|Obama
St. Jude Medical	Abbott Labs
Ray Kroc	McDonald|Micheal Keaton
United States Treasury	CNBC|Jack Lew
Euro Pacific Capital	Peter Schiff
Blackstone Africa	Nigeria
Rouhani	Iran
IPG	Interpublic Group of Companies Inc
Lindsey Graham	Trump
NLSN	INTC|GPN
Ralph Roberts	Comcast
Potter	London|J.K. Rowling
IPO	Bats Global Markets|Sean Rad?
Motor City	Detroit
Paulson	Allergan|U.S.|China|Coleman|Halvorsen|Geithner|US|Rubin Warn|Loeb|SPDR Gold Trust|Fannie|Rubin|Fed|Alibaba|USA
News Corp	U.S.|Ex-Venezuela
Skype	US|Europe|Edward Snowden|Syrian Electronic Army
Scalia	U.S. Supreme Court|Obama|U.S.|Reid|Supreme Court|Supreme Court?
CNBC Launches Marketing Drive	World Economic Forum
Hagel	Obama
Christine Lagarde	IMF|Sara Eisen|World Bank|CNBC|Jim Yong Kim
Duchenne Muscular Dystrophy	FDA
Wall Street	Fed|CNBC Fed|Clinton
Corus Entertainment	Shaw Media
KSS	CBS
Eni	Libya
Dish Network	Verizon
New York State Sues Exxon	Brooklyn
Dick Bove	US|Bank of America
Erawan	Bangkok
Diyarbakir	Turkey
Pemex	Jose Antonio Gonzalez Anaya|New York|Pena Nieto|Mexico
Travis Kalanick	CNBC
Cristiano Ronaldo	Real Madrid
KORS	TIF|HRL
Mersch	ECB
Burger King	Wendy|Buffett|McDonald
Hu Wants U.N.	China
Asia Pacific	CNBC|Pauline Seow|Salesforce|DHL
BMW	Seattle|Europe|U.S.|Asia
Cook	Apple|Steve Jobs|Carl Icahn|China|Cramer
Time Warner-Fox	Ken Griffin
Anhui Conch	China
Ukraine	Russia|Putin|IMF|Yanukovich|Greece|Odessa|S&P|EU|US|Defense|Syria|Obama|Army|Soros|Biden|Slovakia|Poroshenko|Europe|U.S. Midwest|U.S.|Minsk|Coca-Cola|Crimea
Bank Break-Ups	Fed
Michael Carter-Williams	NBA
Carolina Panthers	Waffle House
EE	BT
Patterson	Fed
United States	Putin|Paris|China|Iran
Mark Dunkerley	Hawaiian Airlines
George H.W. Bush	Cheney
Shaw Media	Corus Entertainment
EU	UK|US|Obama|Britain|Google|Cameron|Turkey|Greece|Poland|Japan|Merkel|U.S.|Juncker|Facebook|Rehn|Europe|France Leeway|Paris|Draghi|MSC|WTO|ECB|SAB Europe|Germany|Williams & Glyn|Carney|Sudan|Syria|Brexit|Katainen|Trump|Kiev|Luxembourg|Mexico|Norway|Bulgaria|Serbia|England|IMF|Allergan|Intel|Fuchs|Cyprus|RBS|Ukraine|CNBC
T Rowe Price	Tesla
Cyrus Poonawalla	Mumbai|India|Lincoln House
Simon Xie	Jack Ma
Bill Campbell	Silicon Valley|Silicon Valley?|Apple
ECA	Volkswagen
Evans	Fed|US
Boston	St. Louis|Immelt|GE
Brian Shactman	Mark Haines
Wangzhou Fortune	Yang Weiguo
Groupon	IBM|Amazon|Netflix
Harper Lee	Donald Trump|Trump
NASA	Mars|Bolden|Hollywood|Pluto|Bezos|Crucial Calif.
Bratz	Britney|Taylor Swift
UCSF	Weills
US FTC	Volkswagen
Lego Group	John Goodwin|CNBC
Interpublic Group of Companies Inc	IPG
CNBC	Warren Buffett|Domm|Steve Liesman|Jim Cramer|Stock Market|Fed|CNBC Media Alert|U.S.|IMF|China|Asia|Michael Santoli|Katie Little|Sara Eisen|Buffett|Bill Ackman|European Central Bank|America|Washington|US|OPEC|Virginia|Susan Li|Quintanilla|Faber|Dallas Fed|NYSE|Lang Lang|Mark Haines|Top States|Duke of York|David Faber|Top Travel|CBS Corporation|Lehman Brothers|Jessye Norman|Europe|Aerin Lauder|United States Treasury|United Airlines|Jochen Zeitz|Oscar Munoz|Carla Bruni-Sarkozy|Neel Kashkari|Kobi Alexander|Google|New York|Leslie Moonves|Tim Cook|Federal Reserve Bank of Minneapolis|Diane von Furstenberg|Julia Boorstin|Phil LeBeau|Philip Green|Erin Callan|Matt Damon|Jack Dorsey|Bob Pisani|Jimmy Carter|Maria Sharapova|Jack Lew|Gasparino|North Carolina|GOP|SEC|Sherry Lansing|Federal Reserve|Martin Sorrell|Cherie Blair|Stanley Fischer|Square|Justin Trudeau|Pershing Square|Boris Johnson|Joe Papa|Yellen|Sung-Joo Kim|Lauren Bush Lauren|Bill Clinton|Ford|Clinton|San Francisco Fed|Andre Agassi|Carl Icahn|Rob Kaplan|Travis Kalanick|Lego Group|Lee Seow Hiang|Eric Schneiderman|Nils S. Andersen|Barry Diller|ECB|Wal-Mart|European Commissioner for Economic & Financial Affairs|Stephen Hester|LSI|Asia Pacific|Moritz Kraemer|Martin Gilbert|Massachusetts|Merck|Nike|Christine Lagarde|Phil Knight|Federal Reserve Bank of St. Louis|EU|Jin Liqun|Patti Domm|Klaus Kleinfeld|Jim Cramer?|Arne Sorenson|South Korea|BlackRock|Sharon Epperson|Harwood|Russia|Kenneth Frazier|Ebbers|John Rice|Federal Reserve Bank of Chicago|James Bullard|Carsten Kenteger|Jeremy Darroch|Trump|Pickens|Brian Krzanich|Philippines|Marcus Schenck|Political Beliefs Into ` Blind Trust|Veerathai Santiprabhob|Hitachi|Allergan|Austan Goolsbee|Harris Georgiades|David Faber Interviews Blackstone|Blackstone|Intel|Peter Hancock|PT Trans Media Corpora|Yves Mersch|Brad Tilden|Stefan L?|Ken Moelis|Miami-Dade County|Goldman Sachs|Jim Yong Kim Speaks|Nicos Anastasiades|Dallas Mavericks|Expedia|Jack Welch|Manuel Caldeira Cabral|Bank Stocks|Pauline Seow|Ted Cruz|Regions Top Travel|California|Draghi|Keith Weed|Ben Bernanke|Becky Quick Speaks|Mark Wilson|Joe Biden|Jay Leno|Jeff Smith|Alaska Air|George W. Bush|S&P|Donald Trump|Julia Gillard|Alcoa|Real Madrid|Dennis Lockhart|SBA|Bank Negara|Ahmed Al-Maktoum|IBM|Carlos Gimenez|Jim Chanos|Mark Hoffman|Coke|Irving Picard|Zeti Akhtar Aziz|JPMorgan Chase|Mario Centeno|Yannick Bollor?|Kynikos Associates|Changi Airport Group?|Melissa Lee|CMO|Havas|Rovell|Haines|Yanis Varoufakis|Richard Arnold|Becky Quick|MARTIN LUTHER KING|Tidjane Thiam|Securities and Exchange Commission|Glenda Long|Standard & Poor|Indonesia|Shari Redstone|Bausch & Lomb|Former Federal Reserve|David Solomon|Cyprus|Carlos Ghosn|Yoon Returns|Viacom|Kernen|Hayman Capital Management Managing Partner Kyle Bass Speak|Charles Evans|Republican Presidential Candidate|Utah|de Klerk|Sokol News|Carolyn Fairbairn|Steve Schwarzman|AT&T|BRICS|Jonathan Gray|Wall St|Sandy Weill|Nelson Peltz|Frans van Houten|Raghuram Rajan|Giorgi Kvirikashvili|Jens Weidmann|Enda Kenny|Doha|George Osborne|Billionaire Investor Warren Buffett Ahead of Berkshire Hathaway?|David Sheehan|GM|Volkswagen|Farnoosh Torabi|Federal Reserve Bank of Atlanta|Credit Suisse|Bezos|Suhail Mohamed Faraj Al Mazrouei|Claman|UBS|Citigroup|Orbital|Frederik Willem|Emirates Group|Marco Rubio|Hiroaki Nakanishi|Epperson|Region 's Top Travel|Obama|Pauline Chiou|Jamie Dimon|Texas|Hans Vestberg|Lagarde|Tevin Vongvanich|Icahn Enterprises|Treasury|Colorado|University of Chicago Booth School of Business|BOJ|David Cush|Liz Claman|John Boehner|Kevin Brady|Hadley Gamble Speaks|CNBC Digital Video|AIG|CNBC Fed|Marriott International|Maria Contreras-Sweet|Haider Al-Abadi|Taoiseach|Jes Staley|Pisani|European Union|Larry Fink|Amanda Drury|BellSouth|Scott Cohn|Virgin America|Meg Tirrell|Brent Saunders|New York Mike Bloomberg Sits Down|John Williams|Charlie Munger|Manulife Asset Management Partner|Trump Organization|Detroit Auto Show Today|Kevin Spacey|Margrethe Vestager|Brian Kelly|Gates Foundation|IndyMac|Mario Moretti Polegato|DBS|Andrew Ross Sorkin|Medicare|Financial News Channel|Herman Gref|Larry Page|Alan Greenspan|NATO|Sergey Brin|Scott Wapner|Jane Wells|Pierre Moscovici
Zumiez	Petsmart|Arqule|Yahoo
Justin Trudeau	CNBC|Susan Li|CNBC Media Alert
Bausch & Lomb?	Bill Ackman
Beltway Drama	Hogan
Martha Stewart	Macy 's
Vienna	Baghdad
Sirius	Netflix|Icahn|Nader
Keurig Green Mountain	David Einhorn
Algeria	China|Statoil|US|Saipem
Quintanilla	CNBC|China|U.S.
Alton Towers	Merlin Entertainments
WPP	U.S.|Martin Sorrell|Sorrell|India
Puerto Rico	Congress|Treasury|U.S.|Senate|House|US|U.S. House|Garcia Padilla|White House|Zika|Government Development Bank|Jeffrey Gundlach|Hatch|Trump
Larry	America
Schwarzman	Blackstone|Trump
Delta	Bombardier|Virgin Atlantic|China|Aeromexico
Belgium	Watching USA|Brussels|NYC|Salah Abdeslam
VIACOM	DAUMAN|SUMNER REDSTONE
Bausch & Lomb	CNBC|Bill Ackman|Scott Wapner
Xi Jinping	China
Chicago Tea Party	Rick Santelli
Intrade	McCain|Obama
Tsai	Taiwan
Lippo	US
Farnoosh Torabi	CNBC
Montreal	Canada
Malik	US
SpaceX	Falcon|Elon Musk|Tesla
USA Today	DOJ|Apple
World Bank	IMF|OECD|UN|Peru|Sara Eisen|Russia|AIIB|China|Beijing|Jim Yong Kim|Canada|Egypt|East Asia|Venezuela|Christine Lagarde
Road	Warren Buffett
EXCLUSIVE-China	U.S.|Terex
Cyber Santa Shines Light	Europe
Keith Meister?	Yum Brands|Corvex
FTC	Herbalife|Endo|DeVry|Staples-Office Depot|Volkswagen|Amazon
Chevy Bolt	LG|GM
Taoiseach	CNBC|Enda Kenny
Wong Wai Ming	Lenovo
HSBC	UK|Mexico|Amaggi|Abe|U.S.|Credit Suisse|Sri Lanka|Britain|Panama|Danone|Brazil|Europe|Japan|Louis Dreyfus|Shanghai|Reuters|Hong Kong
Goldman Sachs	US|Blankfein|Hong Kong|Warren Buffett|SAC|Hillary Clinton|Australia|Justice Dept|Fed|Kremlin|David Solomon|Peter Schiff|Abby Joseph Cohen|Corrigan|Canada|OPEC|China|CNBC
Caitlyn Jenner	Mills
New Orleans	Veolia
Tisch	Giants
US Congress	Jack Lew|China
Petrobras	Cramer|Mendes Junior
Cecil	Zimbabwe
Buy Amazon	Facebook
Bob Benmosche	AIG|Peter Hancock
Xstrata	Glencore
K-tel	Philip Kives
TSLA	LULU|NWL|MAR|CMG|LVS|NFLX|EMC|KMB|GPRO
Mumbai	Lincoln House|India|Cyrus Poonawalla
Raymond James	China
Peng	UK
Zurich Insurance	Singapore
VTB	Russia
WBA	ZNGA|PHM
Sean Rad?	IPO
Amelia Island	Ferrari|Jerry Seinfeld
Odessa	Ukraine
Rovell	CNBC
John Paulson	Europe|Warren Buffett
Iceland	Assad|Panama|Greece|Putin|Rhode Island
Virginia	CNBC|Top States|New Jersey|New York|Norfolk Southern
Oyu Tolgoi	Rio Tinto
Walmart	US
Germany	Merkel|Draghi|China|ECB|US|European Central Bank|Michigan|EU|Airbus|Syria|Snyder|Britain|Europe|Schaeuble|France|Obama|Fuchs
UCB	DaimlerChrysler|Ahold|Bulgari|Pearson
Kim	North Korea|N. Korea
South Carolina	Clinton|Colbert
Sky City	NZ
Stephen Hawking	UK
Melissa Lee	Miami-Dade County|Carlos Gimenez|CNBC
Madison Square	Sotheby
Youngwood	JPMorgan
RBS	EU|UK|Williams & Glyn
Hawaii	Worst State for Business|America
Songdo	Hamburg
ICAP	Darrell Read|Tullett Prebon|Martin|London|Libor
Waldorf	New York
Transocean	Devon Energy|Soros
Fiat Chrysler	Google|Ferrrari|Marchionne|US|NAFTA
Steve Schwarzman	David Faber|Blackstone|CNBC|Hayman Capital Management Managing Partner Kyle Bass Speak
Mark Mahaney	Facebook Amazon Netflix
RBC	S&P|Fed
Jeff Gordon	Axalta|NYSE
RBA	US|Asia|Bank of Korea|BI
Janet	Mario
Google	Apple|Amazon|Facebook|Microsoft|US|Ford|Yahoo|NSA|EU|Fiat Chrysler|Eric Schmidt|YouTube|CNBC|China|California|Europe|China?|Sergey Brin|Hyundai|Getty|Lee Sedol|Novartis|Ruth Porat|Tech|India|Sprint|Pentagon|Trump|Roku|Peter Thiel|Hollywood|Vic Gundotra|T-Mobile|Don Draper|Equinix|FBI|Calacanis|Verizon|Motorola|Zuckerberg|San Francisco|Schmidt|Baidu|Thiel|Waze|Osborne|Warren Buffett|John McAfee|Tim Cook|Larry Page|France|Bezos|Prince|Patrick Pichette|GOP Trump|Fed|Toyota|Keystone|Mobvoi|Bill Ford|Chevy|Iowa|Virgin Atlantic|Honeywell|Washington|Megan Smith|Cuba|SoftBank|Nepal|Samsung|U.S.|LAPD
Dick Fuld	Healthcare|Bill Poole
State House	White House
CDK Global	Elliott
China Block UN	Russia
JPMorgan	Dimon|Fed|US|Lebovitz|Hong Kong|Jamie Dimon|Youngwood|Asia|Japan|Yellen|Tom Lee|Madoff
JC Penney	Macy|Bill Ackman|Hodges|Cramer
Curt Schilling?	Videogame Company
Skyworks	Brunswick
Richard Hill	Chipmaker Marvell
Todd Combs	Tracy Britt Cool|Berkshire Hathaway
Bon Jovi	Dave Grohl|Madison Square Garden|Eddie Vedder
Western Europe	American Eagle Outfitters|LMC
Tony Fratto	Mark Haines
AXP	SBUX
San Diego	FAA
NFLX	IBM|CMG|BA|TSLA|YHOO|TEL|AAPL|BBY|CBS|LVS|GE|LULU|NKE|JCP|EMC|WYNN|AIG|ITT|WSM|UNH
Leung	Hong Kong
Surat	India|China
Sberbank	Raiffeisen
Bin Laden	Cramer
Talen Energy	Riverstone
Woody Allen	Amazon|Amazon Studios
Hill	House|U.S.
Suez Canal	Middle East
Amoruso	Nasty Gal
Dartmouth	N.H. AG
Kuala Lumpur	Australia
Feinstein	Calif.
Lazada	Asia
Bass	China|Tepper|Ackman|Chanos
Abu Dhabi	Malaysia|IPIC|MENA|Dubai
Global Logistic Properties	Heather Xie
Cruz	Trump|Rubio|Kasich|Hillary|GOP|Borg|Obama|Trump?|Santelli|US|Paul Ryan Phones Trump|Sanders|Wisconsin|Iowa|NBC-WSJ|Donald Trump
Caterpillar	Cramer|Microsoft|DuPont|China|David Einhorn|Obama|Fed|Senate|PepsiCo
Balkans	Serbia
Marc Faber	Fed|Peter Schiff
Sequoia	India
Glu Mobile	Zillow|Priceline
Mike Bloomberg	White House
Fiat	Pope Francis
Liberia	Sierra Leone|British Airways
A.B. InBev	Grolsch
Sorrell	WPP
Lenin	Russia
Kyushu	Japan
IAG	Nick Hawkins
NAFTA	Fiat Chrysler
IAC	Barry Diller|Angie|Schiffman
Government Capital Bail Out Fannie	Freddie
Zawiya	Libya
Medicare	CNBC
Lehman Brothers	Erin Callan|CNBC|CNBC Media Alert
Gladwell	Gurley
Carl Gaimari	IRS
IRAQ	OPEC|UAE|IRAN
Hadley Gamble Speaks	CNBC|Gates Foundation
Elton John AIDS Foundation	PEPFAR
Athletics-Commission	Russia
PHM	ZNGA|WBA
Mandia	DeWalt
ANC	South Africa
Molson Coors	Vancouver
ValueAct	Ubben|Jeff Ubben
Bank BPH	GE
BP	Dudley|U.S.|US|Gulf of Mexico
Yum China	Pizza Hut|KFC|CIC
Atom Bank	BBVA
California Dreamin	Florida
America Movil	Mexico
Bridgewater	Dalio|Fed|Ray Dalio|U.S.
Fox	Mindy|Disney|Hulu
BRICS	CNBC
France	Italy|China|ECB|UK|Spain|Paris|Obama|US|Strauss-Kahn|LVMH|Putin|Sanofi|Europe|Asia|DCN|Adecco|Hollande|Saudi Arabia|Greece|S&P|Germany|Renault|Russia|Google
El Erian	Fed
Aerin Lauder	CNBC
Jack Ma	Alibaba|China|AC Milan|Alibaba?|America|Simon Xie|US|Bordeaux
John Kasich	GOP
Argentina	Macri|U.S.|Fernandez|Bergoglio|Obama|Panama
Ted Cruz	Carly Fiorina|Donald Trump|Jeb Bush|GOP|Marco Rubio|Hillary Clinton|Barney Frank|CNBC|CNBC Media Alert|Hillary Clinton?|Jeb
Woodside	Mauritania
DANYLYUK	UKRAINE
New York City	Bill de Blasio
Billionaire Investor Warren Buffett Ahead of Berkshire Hathaway?	CNBC|Becky Quick Speaks
Greenlight Capital	Einhorn
Oregon	Portland|NBC|Maryland Obamacare|FBI
Branson Dons	Virgin
Pisani	CNBC|New York
Osborne	UK|Google
Atlas Air	Amazon
Nicos Anastasiades	CNBC|Cyprus
Pope Francis	Pope|Ralph Nader|Greece|Vatican After Trip|Fiat|Vatican Bank
Jameis Winston	NFL
Tehran	Iran
Sony	Obama|Microsoft|Samsung|Facebook|US|Nintendo|Kim Jong Un|James Bond|North Korea|Apple|T-Mobile|Ericsson|China|Panasonic
Costco	Sam|Citi|Woolworths|Amazon
Commerzbank	Zielke
Gurley	Gladwell
Liberty House	Tata Steel UK
Kraft Foods Group	HJ Heinz|Kraft Heinz Co.
BBVA	Atom Bank
Florida	Buffett|Berkshire|David Tepper|Scott|New Jersey|Ohio|California Dreamin
Vivo	China|Apple
Volgograd	Russia
Janus	Bill Gross
Hardee	Carl
LeBron	McDonald|Cleveland
ANF	PBR|CMG|GE|BAC|ZG|YHOO
Sinochem Group	China
Yen	Spain
Fitch	S&P|Africa
GILEAD SCIENCES INC	MERCK & CO INC
Inovio Pharmaceuticals	DARPA
Mosul	Italy|Trevi
Ivy League	Yale
NVO	BHI|MEG|JCP
Richard Sherman	Peyton Manning
Belmont Stakes	California Chrome
Superman	Batman
Western Union	Alibaba|Greece
Iain Duncan Smith	Cameron
Panama	US|Justice Dept|UK|Philip Green|HSBC|NZ|Credit Suisse|DOJ|Bill Gates|Putin|Europe|Iceland|Macri|Mossack Fonseca|Topshop|CIA|Cameron|Assad|Argentina|Fmr|London
Alexander Hamilton	Lin-Manuel Miranda
Pershing Square	Bill Ackman|CNBC|CNBC Media Alert|Ackman
Ball?	Ayotte
Clyde	Bonnie
CNBC Fed	Fed|Yellen|Wall Street|CNBC|Kasich|Steve Liesman
Lahore	Facebook
Uncle Jeb	Lauren Bush Lauren
PIMCO	Japan|Allianz|El-Erian
HKU	Johannes Chan
Elop?	Nokia
Disney	Cramer|Iger|ESPN|Hulu|Sonnenfeld|NFL|Allergan|Facebook|Mickey|Goldberg|Electronic Arts &|Fox|Viacom|Anna|Thomas Staggs|Elsa|BTIG|Tesla|Netflix|U.S.|Bob Iger
Borland	ESPN
Zuckerberg	Facebook|Max|Bezos|Gates|Oprah|Palo Alto|Newark|Cramer|US|Google|Forbes|China
Snooki	Spitzer
U.S. Air Force	Northrop
Robbins	Loeb|Ackman|Glenview
Macy	Kohl|US|JC Penney|Cramer|Trump
Synchrony Financial	Soros Fund Management
U.S. Economist	Jan Hatzius
California	Google|US|Washington|Gerawan|White House|West Coast|William Shatner|Mendocino|Amazon|Fiorina Beat Boxer|Brown|Munger Sandwich|Electric|El Nino|CNBC|Pimco|Alberta|Milken|Meg Whitman|NBA|Lagunitas|U.S.|United Farm Workers|Sun Pacific Bank|Chris Paul|Buffett|Facebook|Orange County
Carl	Hardee
St Louis Fed	Bullard
Milligan	Gilead
Sierra Leone	British Airways|Liberia
Mohamed El-Erian	Japan
Eisner Group	Topps
Lawrence Ho	Batman|Melco
Casino	S&P|Thailand|Vietnam
Ball Corp	Rexam|Ardagh
Tom Lee	JPMorgan
Bayer	Syngenta
Paul Ryan	GOP|House|McCarthy|Trump|Donald Trump
T. Rowe	American Airlines
Julia Boorstin	Square|Jack Dorsey|CNBC
Lin-Manuel Miranda	Alexander Hamilton|Nicki Minaj|Leonardo DiCaprio
FRANKFURT	DUBLIN|PARIS|NEW YORK
Everest	Erik Weihenmayer
SunEdison	Appaloosa|Tepper
Kobi	Alexander
Samarco	U.S.
Aaron Hernandez	NFL
JCPenney	Ackman
Angie	IAC
Chaffetz	Ryan
Qatar	UAE|FIFA|Garuda|Maersk|Oman
Republican Presidential Candidate	Trump Organization|CNBC|Donald Trump
Italy	Spain|ECB|France|Renzi|Milan|Trevi|Swisscom|Alfa Romeo|Medicines Co|Mosul|Starbucks|Monti|AC Milan|Libya|European Central Bank|Draghi|Bank|Percassi|Fastweb|UniCredit|Nouriel Roubini|Greece|Berlusconi
Takata	U.S.|Japan|Senate|Texas|Honda|Mazda|US
T-Mobile Will Let Customers Stream HBO	ESPN|Netflix
US FDA	UK
Supreme Leader	U.S.
WSJ	Dupont|Holmes|Dow Chemical|FDA
Kindle Oasis	Amazon
Krugman	UK
EIA	US|ADP
Citi	US|Orszag|China|Corbat|White House|Pandit|Fed|Buiter|Costco|BofA|Michael Corbat|S&P|Washington
BofA	Moynihan|HB2 North Carolina|Citi|Fed
Richard Arnold	CNBC
Elliott	CDK Global
Abercrombie	Toyota|US|GE|Dell
Foley	Obama
EXCLUSIVE-Nigeria	Doha
Ackman	Icahn|Herbalife|Einhorn|Tepper|New Mexico|Bass|Buffett|Loeb|Fannie|Valeant|Dell|Bloomberg|Allergan|Robbins|SEC|JCPenney|Ira Sohn|China|Pershing Square
WPP Martin Sorrell	China
Lotte Mart	Reckitt Benckiser|Korea
Reckitt Benckiser	Lotte Mart|Korea
Louis Vuitton	Apple|Nike
Yahoo Japan	Yahoo
Ebbers	CNBC
Obama Needles Clinton	Correspondents?
Zeppelin	Cannes
FAA	Israel|Tel Aviv|US|United Airlines|Allegiant Air|San Diego|Philadelphia Airport
Jan Hatzius	U.S. Economist
Alere	Abbott
Mauritania	Woodside
Vermont	SEC|Miami|Trump
Allianz	El-Erian|Europe|PIMCO
LVS	Cramer|TSLA|CMG|EMC|NFLX|LULU
Asia-Pacific	Australia
Cox	Facebook
Instagrammed	America
Williams & Glyn	RBS|EU
All Blacks	Wallabies|John Key
Carl Icahn	Apple|Trump|Bill Ackman|CNBC|Marc Andreessen|Charif Souki|Sanders|Cramer|Cook|Time Warner|Netflix|China|Icahn Enterprises|Cheniere|Donald Trump|Kirk|Leon Black|Chesapeake Energy
Riverstone	Talen Energy
Edmund Phelps	China
Chuck E. Cheese	Buster|Dave
Katainen	EU
JetBlue	Alaska Air|JFK|Virgin America
Jimmy Dunne	Yellen|Fed
Carter	Defense
1-Gap Inc	Sonia Syngal|Navy
Miller	Cooperman
Naoto Kan	Fukushima|Japan
Chertoff	Apple
GOP Donors	Donald Trump
Rato	IMF
Mario Centeno	CNBC
Ed McMahon	Donald|Trump|Donald Trump
Christchurch	New Zealand
Labou	Sadiq Khan|London|UK
Porsche	VW|Volkswagen|Janis Joplin?|Tesla|Jaguar
Mathew Martoma	SAC
Labor	US
CCL	MSFT|GE|GOOGL
Baptist Foundation	Arizona
Gordon Gekko	Trump
AMC Entertainment	Carmike
McDigital	McDonalds|SXSW
Wolfowitz	World Bank Group
Bank of Thailand	South Korea|Japan|Veerathai Santiprabhob
Berkshire Hathaway Buys Omaha Newspaper Despite Industry	Warren Buffett
Bob Pisani	CNBC|New York Mike Bloomberg Sits Down
Nokia	Microsoft|Elop|Elop?|Apple|Samsung|Ballmer
Boris Johnson	CNBC|Thatcher
Sanmina	Canadian National Railway &
Draghi	ECB|Europe|Germany|Fed|EU|Moody|Yellen|Renzi|Italy|CNBC|Weidmann
Acadia	U.S.
Topps	Eisner Group
Khalifa Haftar	Libya
Correspondents?	Obama Needles Clinton
DAVID SACKS	PETER THIEL
Astra	Pfizer|J&J|GSK
Goodell	NFL|Roethlisberger
Ron Paul	Fed|Trump|GOP
Jeb Bush	Rubio|GOP|Donald Trump|Ted Cruz|Trump|San Francisco|Politico|Marco Rubio|Mitt Romney
Charlie Munger	Warren Buffett|Omaha|CNBC|Japan
Rupert Murdoch	London|Jerry Hall|John Malone
West Bank	Israel
Yemen	Libya|Somalia
Latin America	IMF|Europe|Peru
John Kerry	Iran
Pakistan	San Bernardino|Lockheed|U.S. Senate|U.S.|Asia
Takeda	Lundbeck|FDA
WHR	SVU|MMM
UBS	U.S.|Europe|China|US|Bernie Sanders|Axel Weber|Fed|Berkshire Hathaway|CNBC|Federal Reserve
AB InBev	Coors|Brazil|China|SABMiller
Cohen	Barclays|Warren|U.S.
CFTC	Bank
MacDonald	Apple
Bats Global Markets	IPO
Fink	Europe|BlackRock
Santoli	Allergan|Fed
New Beer City	North Carolina
Langone	Kasich|GOP
Alibaba Group	Lazada Group
EU Energy	United States of Europe
Summers	Fed|Yellen|Obama
Merrill Lynch CIO	Fed
Schiff	Fed|America|Yellen|Kass
Gulf	Moody|OPEC|IMF|Iraq|Bahrain
Hyman	Cuba
Former Johnson & Johnson	Burke
NEW YORK	PARIS|FRANKFURT|DUBLIN
Jim Chanos	Tesla|China|Hewlett-Packard|Kynikos Associates|CNBC|Alibaba
Libor	ICAP|Darrell Read|London
Burke	Former Johnson & Johnson
Seoul	Changi Airport|North Korea|Singapore
Biden	Obama|U.S.|Israel|Donald Trump|Ukraine|Greece|Joe|Davos
Liberty Media	Yahoo|John Malone
Ken Langone	Kasich
AMC	Pellicano|Starwood|HAL|CVS|Aron|AMGN
Ad Space & Doggy Doo	Zill Bill
Intuit	TurboTax|Cramer
AMF	Pinault
Northrop Post Sharp Quarterly Gains	Lockheed
Durham	NC
Capital Economics	China
Massachusetts	Patrick|CNBC|Bain Capital
NWL	KMB|TSLA|GPRO
N.H. AG	Dartmouth
Obama Jumps Into	New Hampshire
Morgan Creek	Apple
Morgan Stanley	Fed|US|Goldman|Kroton|U.S.|Greece|Gorman|Japan|S&P|Starwood|Brazil
SXSW	Julian Assange|Cyprus|McDonalds|McDigital|Edward Snowden
Brady	Obama Recovery
Elon Musk	Tesla|Cramer|Hyperloop|SpaceX|Isaacson
First Niagara	KeyCorp
Hawaiian Airlines	Mark Dunkerley
Bill	Texas|Hillary Clinton|Gawker?
Times	China
Aetna	Humana|Centene|Obamacare
TABLE-World Bank	East Asia
Kentucky	Volkswagen
EXCLUSIVE-Brazil	Temer
Bob	Fed
Russia	Ukraine|Putin|China|Turkey|Syria|US|Europe|Saudi Arabia|Crimea|GOP|IMF|Moody|Greece|NATO|Moscow|VTB|AP|Cyprus|Moldova|India|Dmitry Medvedev|Coca-Cola|Bank|Soros|Minsk|CNBC|Asia|Iraq|France|West|World Bank|Iran|Kremlin|Ankara|Boone Pickens|Kudrin|OPEC|Gazprom|Hollande|Latvia|Rosneft|ISIS|Nigeria|Detroit|Khodorkovsky|Hague|North Korea|Doha|Putin-Obama|Volgograd|Cuba|Sechin|Pepsi|IRS|Lenin|S&P|Athletics-Commission|Poroshenko|George Soros|China Block UN|IEA|Mideast|U.S.|Army|Obama|Mozambique|Georgia
NYSE	CNBC|SEC|Gasparino|Nasdaq|P&G|Jeff Gordon|Vietnam|ISS|Axalta|Verizon|National Baseball Hall of Fame
Jin Liqun	CNBC
Romania	Colombia|Poland|Austria|Europe
Square	Jack Dorsey|Julia Boorstin|CNBC|Herbalife
Atlantic City	New Jersey|Prieto|Trump|Icahn
Atlanta Hawks	Bruce Levenson|NBA
SolarCity	Jim Cramer|Rackspace
MDC	Gotham City
COO Hart	United Airlines|Port Authority
Leonardo DiCaprio	Lin-Manuel Miranda|Nicki Minaj
Tom Brady	NFL|Cramer
Ralph Lauren	Richemont
Simon	US|Wal-Mart
Marc Andreessen	Kirk|Carl Icahn
Calais	Eurotunnel
ACN	KBH|YHOO|WFC
CapitaLand Limited	Arthur Lang
U.S. Supreme Court	Scalia|Wal-Mart|House|Seattle|Iran
OPEC	US|Doha|Iran|Saudi Arabia|UAE|CNBC|Asia|Iraq|U.S.|non-OPEC|Badri|IRAQ|Keystone|IRAN|Epperson|Sharon Epperson|Russia|IEA|Gulf|Angola|Steve Sedgwick|El-Badri|Moscow|Goldman Sachs|ECB|Venezuela|China|Kuwait|Wilbur Ross
Lagardere	EADS|BAE
Perry	Texas|Loeb
Michael Bay	Samsung
Tina Turner	Cramer
Emaar Malls	Dubai
San Bernardino	FBI|Syed Farook|ISIS|Tashfeen Malik|Rizwan Farook|Pakistan|Apple
Pellicano	AMC
Oyak Bank	Turkey
Boulder	GOP|O'Malley
Anheuser-Busch InBev	Asahi|SAB
Sharon Epperson	CNBC|OPEC
Appointing Lew Treasury	Obama|GOP
EXCLUSIVE-Mexico	ICA
Hyperloop	Musk|Tesla|Elon Musk
Dalian Wanda	China|Hollywood|Blackstone|UFC
Joe Biden	Washington|CNBC
Rio Tinto	Mongolia|Oyu Tolgoi
NODX	Singapore
Anthony	Knicks
Ex-Venezuela	News Corp
Feds	Apple
Moniz	Energy
Koch	Trump
Kozlowski	Tyco|Party
Nieto	Mexico
Ferrrari	Marchionne|Fiat Chrysler
Buy Tumblr	Yahoo
Ramy Aziz	ASX Group
Lerner	Embroiled IRS
Facebook Amazon Netflix	Mark Mahaney
Kocherlakota	Fed|US
AB Inbev	Australia
BBBY	FDX|TWX
Dan Loeb	DuPont|Geico|Liveris|Dow|Yahoo
Mass Mutual Life Insurance	US|MetLife
Gucci	US|Alibaba|Hong Kong
Region 's Top Travel	CNBC
Mario Moretti Polegato	CNBC
Switzerland	Singapore|Venezuela|Europe
Texas Appears in Court	Rick Perry
Marriott	Starwood|China|PayPal|Anbang|Starwood Hotels|Brussels|Facebook
Mark	Priscilla Zuckerberg
Austin	Lyft
Beijing	China|Paris|Asia|World Bank|Europe|NPC|South China Sea|Venezuela|San Fran|White House|US|Japan
MEG	JCP|BHI|NVO
Mark Carney	Bank of England
Adecco	France
Twitter	Shun Facebook ` Drama|Jakarta|NBA|Cramer|Facebook
Bob Iger	Disney|China
Africa	Middle East|South Africa|CNBC Europe|AMCU|Steinhoff|US|Guptas|Darty|Sibanye Gold|Ohio|India|Fitch|Hotel|S&P|NBA
Ironwood	U.S.
EBAY	PNRA|UNH|IBM
Egypt	Jordan|Pimco|Citadel Capital|U.S.|Tut|Uganda|Felipe Calderon|World Bank|US
George W. Bush	CNBC|U.S.|Lauren Bush Lauren
Brin	NSA
Cameron Wants Europe	UK
Buffett Hosts Obama Fundraiser Tonight	Becky
Kudrin	Russia
NJ Assembly	Tesla
Orbital	CNBC|U.S.
Tony Trenkle	CMS
Blankfein	Goldman|Goldman Sachs|Trump|Sachs
Detroit Auto Show Today	Phil LeBeau|CNBC
Tate	Tom
Intermarine	Houston
Shark Tank	Robert Herjavec
Tata	UK|Cameron
Klaus Kleinfeld	CNBC|Alcoa
Leap Wireless	AT&T
South China Sea	China|US|US Navy|Philippines|Vietnam|Beijing|Hague
Westinghouse	Toshiba US
Eric Cantor	Warren
Manhattan	Donald Trump|New York|Zeckendorf|NASCAR
Trump?	Icahn|Cruz|New York|Rubio
Lugar	Indiana
Pebble Beach	Ferrari
Haines	CNBC|Mark Hoffman|Cramer
NCLH	STMP
Marcus Schenck	CNBC
Lumileds	U.S.|Philips
Twitter IPO	Cramer
Max	Zuckerberg
Bank of America	Barron|US|AIG|S&P|Cramer|Dick Bove|Moynihan
Goldman Sachs Unexpected	Warren Buffett
Kass	Schiff
Bill Ford	Apple|Google
John Boehner	Janet Yellen|CNBC
Tourbillon	MannKind
Liz Claman	CNBC
George Gilder?	Fed
Enron	Justice Department
Andrew Forrest	Fortescue
Metro	Yellen|Brussels
Netflix	Amazon|Hulu|IBM|Reed Hastings|Cramer|Asia|Japan|Apple|Sirius|Groupon|Google Chromecast|Viacom|Carl Icahn|Rob Lowe|FCC|Epix|China|T-Mobile Will Let Customers Stream HBO|Landis|Fuller House|U.S.|Comcast|Hollywood|United Airlines|SoftBank|U.S. FCC|Macy 's|ESPN|Disney
Norquist	Clinton
StanChart Iran	London
Andrew Bogut	NBA
CLP Holdings	Geert Peeters
Ex-Deutsche Bank	UK
AP	Marina Villeneuve|IRS|White House Causes Stocks to Briefly Plunge|Russia
Teva	Allergan
Saudi Arabia Iran	Doha
Liveris	Dow|DuPont|Dan Loeb
Jeff Immelt	GE|China
Lucara	Lesedi La Rona
NKE	CS|JCP|AZO|BBY|NFLX
Showtime	HBO|Canelo|Wynn
Sergey Brin	Google|Larry Page|Jeff Bezos|CNBC
McCrery	Rangel
Athenahealth	Einhorn
Scott	Florida
Citrix	eBay
Ahmed Al-Maktoum	CNBC|Emirates Group
LA.	NFL
MARTIN LUTHER KING	CNBC
Fla.	Fisher Island
Pete Najarian	Apple
Beyonce	Lululemon
Sports Authority	Dick|US
Dilma Rousseff	Brazil
Tomlinson	Madden|Rutgers
Kobi Alexander	CNBC
Citigroup	China|Pandit|CNBC|Fed|Larry Summers|Sandy Weill
Workers Party	Rousseff|Brazil
Bonds	Key Commodities
Azimo	Rakuten
UAW	VW
Kochs	Billionaire Steyer|Scott Walker|Rubio
Real Madrid	CNBC|Manchester United|Cristiano Ronaldo
Gazprom	Naftogaz|Russia|Shell|China
UAL	Bethune|HAL|LH|Cramer|BLL|CTXS|VIAB|BBT
UAE	OPEC|CME Group|IMF|IRAQ|Asia|Qatar|Ridley Scott|IRAN
Tories	Brexit
Prudential	Inditex|UK
Whitman	HPE
P&G	Buffett|NYSE
Styldrift	South Africa
Austan Goolsbee	CNBC|Fed|Ex-Obama|University of Chicago Booth School of Business
Lauren Bush Lauren	CNBC|Uncle Jeb|U.S.|George W. Bush
Woolworths	Costco
Li Ka-shing	Cheung Kong
Kuroda	BOJ|Japan|Abe
PT Trans Media Corpora	CNBC|Indonesia
Brent Saunders	CNBC|Allergan
Tyco	Party|Kozlowski
DirecTV	AT&T|FCC
Defense	Carter|Paris|Ukraine
Hong Kong Look	Singapore
Jeffrey Gundlach	Cramer|Puerto Rico
Mark Haines	CNBC|Vince Farrell|Brian Shactman|Jane Wells|Tony Fratto|Darren Rovell
DAUMAN	SUMNER REDSTONE|VIACOM
Seattle	U.S. Supreme Court|BMW|Denver|Supreme Court|US|U.S.
Turkey	Russia|EU|Ankara|Iraq|Erdogan|Greece|Oyak Bank|Diyarbakir|ISIS|ING|Kirkuk|Islamic State|PKK|Cyprus|Istanbul|Moscow|Syria
Julia Gillard	CNBC|Hillary Clinton
Jack Welch	CNBC|Warren Buffett|Trump
Hire Trichet	Bernanke
Theranos	Elizabeth Holmes|US
Veolia	New Orleans
Byron Wien	S&P|New York
ASX Group	Ramy Aziz
UOB	Israel|Singapore
State	Michigan
Knicks	Anthony
Abramovich	Emirati
JPMorgan Chase	Jamie Dimon|US|CNBC|Hank Paulson|CNBC Media Alert
Margaret Thatcher	UK
Maryland	Connecticut|U.S.
Norway	EU|Airbus
Stamford Harbor	Steve Cohen
Mekong	Japan
Thomas Herzfeld	Cuba
N Carolina	Deutsche Bank
Sarah Palin	McCain
Oscar Munoz	Jim Cramer|United Airlines|United|CNBC|Jeff Smisek|United Continental
Dilma	Brazil
Government Development Bank	Puerto Rico
Larry Summers	Fed|Jon Tester|US|Citigroup|Obamacare
Carrie Hammer	Shanghai
KASHKARI	U.S.
America	Top States|Trump|CNBC|Instagrammed|Buffett|CNBC Wealth|Schiff|Donald Trump?|Washington|Hollywood|Tim Cook|Joe|Joe Conforte|Bud|Ex-Indiana|Babson|China|Harvard|Warren Buffett|Marijuana Inc|Narendra Modi|Flint|Chicago|Chris Christie|U.S.|House|Texas|Hawaii|Steve Case|US|Chevrolet|Jack Ma|Boeing|Colorado|Larry|Hormel
Disney COO	Iger
Motorola	Google|Eric Schmidt|Verizon|Microsoft
Emirates Group	Ahmed Al-Maktoum|CNBC
Hasbro	YouTube|Mattel
Dupont	WSJ|Dow Chemical
Equinix	Google
Yum	KKR|China
Cargill	Brazil
Devon Energy	Soros|Transocean
Jay Z	Kanye West|Pablo
Patrick Harker	Federal Reserve Bank of Philadelphia
Joe Papa	Jim Cramer|CNBC|CNBC Media Alert
Kernen	Buffett|CNBC
Drugmakers Mallinckrodt	Mylan
Energy	Moniz|Chesapeake|GE|Doha|Williams
TurboTax	Minn.|Intuit
CBO	Obamacare
CBS	Moonves|NFLX|Time Warner|ROST|NFL|EXPR|Apple|AIG|ITT|Diller|Redstone Tells CNBC|Star Trek|CMG|AZN|BA|DRI|Viacom|O'Donnell|WYNN|KSS|ULTA|NBC|Redstone
Geico	Dan Loeb
McCartney	Dylan
Sony Pictures	Snowden|Alibaba
Sepp Blatter	FIFA
Ruth Porat	Google
Shanghai Comp	China
Amtrak	US|Philadelphia
Edison International	U.S.
AMSC	Strengthen Power Grid
Leon Cooperman	Wells|Omega|Hillary Clinton
Jose Maria Aznar	Spain
Fmr	Panama
Kirk	Marc Andreessen|Carl Icahn
Jim Yong Kim	IMF|Christine Lagarde|World Bank|Sara Eisen
Manila	Bangladesh
Plosser	Fed
MSFT	GE|GOOGL|CCL
Oracle Corp	ORCL
Votorantim	Peru
Leonardo	Shakira
Federal Reserve Bank of Chicago	Charles Evans|Steve Liesman|CNBC
British Airways	Liberia|Sierra Leone
EADS	BAE|Northrop|Lagardere
Occidental Petroleum Corp	OXY
NATO	Russia|Kremlin|CNBC
MDVN	ATHM|GM
Kapito	BlackRock
Lockheed	Pakistan|Northrop Post Sharp Quarterly Gains
Bill Richardson	Korea
CNBC Wealth	America
CNBC Europe	Africa|Middle East|Hotel
Centerview Partners	DreamWorks Animation
Bill Clinton	CNBC|US|Hillary|Bernie Sanders|Donald Trump
Denmark	Sanders|Clinton|Therkelsen
Megan Smith	Google|US
Joseph Papa	Perrigo
S&P	US|Dow|Casino|Wall St|China|Fitch|New York|France|Russia|Congress|Cramer|AAA|ExxonMobil|Gilead|Obama|SocGen|Ukraine|Africa|Nasdaq|Greece|Bank of America|Europe|Hong Kong|Berkshire Hathaway|Catholic Values|Rio|Jim Paulsen|Warren Buffett|IBM|Fundstrat|Citi|Chicago|Goldman|Fannie|RBC|Apple|Byron Wien|Illinois|Fed|Cashin|BHP|Austria|Yellen|CNBC|Morgan Stanley
J.K. Rowling	London|Potter
World Health Organisation	Guinea
ZenoRadio	Pandora
john stumpf	U.S.
SpaceX Falcon	Bezos
Abdeslam	Paris Attacks
Ghostface Killah	Martin Shkreli
Berlusconi	Italy|Mediaset|AC Milan
Kayla Tausche	Atlanta
Kuczynski	Peru
Estonia	Tennessee
UCLA	NCAA
Liu Yiqian	Modigliani|Christie
Barclays	ING|Jenkins|Nomura|China|SEC|South Africa|Jes Staley|ANZ|NY|Glencore|Cohen|Credit Suisse|Goldman|US
Fedmas	Janet Yellen|Yellen
Stan Druckenmiller	Fed
Mark Wilson	CNBC
Juniper	U.S.|Congress
Fort Mac	Canada
Piyush Gupta	DBS
Alibaba IPO	China
Gamechanger	Apple
Tribune Publishing	Gannett
Westbrook	Durant
RUSAL	Cheung
Steve Cohen	SEC|Stamford Harbor
Borneo	Najib|Malaysia
Gannett	Tribune Publishing|Tribune
PayPal	Facebook|Jim Cramer|Indiana|Marriott|Max Levchin|eBay
Forbes	Gates|Zuckerberg
Aveo Pharmaceuticals	U.S. SEC
Patrick Pichette	Google
Pioneer	U.S.
Sheryl Sandberg	Facebook
Cleveland Browns	Nike
Party	Tyco|Robin Hood|Kozlowski
Winklevoss Twins	Never Mind Facebook
IAAF	Adidas
Topps Dollar	Virginia Tech Merchandise|Curt Schilling
WEF	Trump
Aoki	Benihana
BellSouth	AT&T|CNBC|FCC|McDowell|Faber
Bank Stocks	CNBC|Warren Buffett
Schwarzenegger	Trump|House
Harris Georgiades	CNBC
Kobe Bryant	Lakers|Los Angeles Lakers|NBA
Federal Reserve Bank of St. Louis	CNBC|James Bullard
McLaren	Bahrain
Silk Road	US
Farrell	US
Dennis Hof	Bunny Ranch|US Senate
KFC	Yum China|China|Pizza Hut|CIC
NHS	UK
US House	US|Ryan|Iran
Makro Stores	Tesco
Bove	Goldman
SABMiller	Coors|Greenwich Meantime|AB InBev
Scott Walker	GOP|Kochs
KeyCorp	First Niagara
Philips	Lumileds|U.S.
ABC	DISCA|Univision
Emmanuel Stroobant	Singapore|Edina Hong
Doomsayers Nouriel Roubini	Peter Schiff
Medicare Advantage 2017	U.S.
Epic Systems	U.S.
Nissan	Ford|Europe|UK
Lakers	Kobe Bryant
Ryan	Trump|US|Obama|US House|Chaffetz|House|Iran|Palin
SABIC	Saudi Arabia
Danone	HSBC
Carlos Gimenez	Miami-Dade County|Melissa Lee|CNBC
Bill Miller	Legg Mason|IBM|Warren Buffett
BHI	JCP|BA|AAPL|YHOO|GRMN|NVO|AIG|NOC|MEG
Sherry Lansing	CNBC|US
Apple	China|Google|Samsung|FBI|US|Tim Cook|Cramer|Microsoft|Icahn|Siri|Tesla|Carl Icahn|Amazon|Cook|Louis Vuitton|Nike|Fed|Huawei|Singapore|Xiaomi|John Sculley|Cisco|IBM|Facebook|AT&T|Ericsson|BOJ|U.S.|Silicon Valley|Trump|DOJ|Jia Yueting|HBO|North Korea|Yellen|Bill Campbell|Dre|MLB|Taiwan|Steve Wozniak|St|Gamechanger|Bill Ford|Justice Department|Vivo|S&P|Landis|Pete Najarian|Wal-Mart|Feds|CBS|Nielsen|ESPN|Wall St|Moonves|USA Today|Alibaba|NCAA|Australia|India|Paypal|Arizona|MacDonald|Netflix|Comcast|Syed Farook|SEC|GOP|GM|Lebenthal|Sony|Spotify|Toyota|Jeff Williams|Pandora|Nasdaq|Asia|Nokia|Morgan Creek|Gundlach|N.Y.|Dell|Ford|Chertoff|Roku|LSE|Steve Jobs|Clinton|LeEco|Goldman|Dow|Foxconn|San Bernardino|Chevy|Daniel Coster|O'Leary|Steve Jobs Keynote
ST Microelectronics	Air Berlin|Adidas
Monsanto	Syngenta
Sawiris	EFG-Hermes
Middle	Brazil
Lazada Group	Alibaba Group
Tennessee	Estonia|GM|U.S.|Michigan
Greece	IMF|Merkel|China|Tsipras|Russia|EU|Europe|Athens|Italy|S&P|France|Morgan Stanley|Turkey|Wilbur Ross|Nasdaq|Iceland|Gartman|Pandora|Buffett|Ukraine|Pope Francis|Biden|Spain|Dombrovskis|Barroso|Piraeus Bank|Cramer|Lagarde|Lew|U.S.|Yanis Varoufakis|US|Malaysia|Western Union
BHP	Vale|Rio|Brazil|S&P|Athens|Andrew Mackenzie|China
Quintiles	IMS Health
Priceline	Darren Huston|Zillow|Glu Mobile
Topshop	Philip Green|Panama|Bangladesh
Regina	China
Hasenstab	Templeton
GOOGL	GE|CCL|MSFT
Smith	Yahoo
Dudley	Fed|US|BP|U.S.
NOAA	U.S.
Airbnb	Jared Leto|Fidelity|Nathan Blecharcyzk|China
Phillips	Buffett|Berkshire Hathaway
Shell	BG|Hertz|Lyft|Statoil|Gazprom
Rackspace	SolarCity|US|China
Jim Koch	Boston Beer Co.
Bruni-Sarkozy	Bettencourt
David Faber Interviews Blackstone	Jonathan Gray|CNBC
LePage	Maine
Hewlett Packard Enterprise	HP Inc.|HP
Halvorsen	Alibaba|Coleman|Loeb|Paulson
Marc Trestman	Rex Ryan|NFL
Nevada	Trump|Tesla|Hyperloop Technologies|Harry Reid|Sheldon Adelson
Charles H. Blood	Brown
Sina	Weibo|Alibaba|Charles Chao
Dubai	Abu Dhabi|Qatar Air|Mideast|MENA|Syria|DIFC|Emaar Malls
Garcia Padilla	Senate|Puerto Rico
Jochen Zeitz	CNBC
Miami	SEC|Vermont
Allegiant Air	FAA
Ronaldo	Airbus|Obama
Lincoln House	Cyrus Poonawalla|India|Mumbai
Yanis Varoufakis	UK|Greece|CNBC
SanDisk	Cramer
Glenview	Robbins
Carnival	Cuba
Softbank	Japan
David Solomon	Goldman Sachs|CNBC
Katz	Qualcomm
Boone Pickens	Cramer|Russia
Jared Leto	Airbnb
Sam	Costco|Amazon
Tech Star Pogue	Mayer|Natch
Facebook IPO	Nasdaq|Cramer
Badri	Iran|OPEC
Sara Eisen	CNBC|IMF|Christine Lagarde|Phil Knight|Nike|Jim Yong Kim|Former Federal Reserve|Jim Yong Kim Speaks|CNBC Media Alert|Alan Greenspan|World Bank
Roethlisberger	NFL|Goodell
Yuvraj Singh	India
ROST	CBS|DRI|CMG|EXPR
Steve Jobs Keynote	Apple
Fed	US|Yellen|China|CNBC|ECB|BOJ|Dudley|U.S.|Fischer|Cramer|Williams|Lockhart|Summers|Bullard|Ben Bernanke|Europe|Bernanke|Trump|Asia|Lacker|Larry Summers|Gundlach|US Treasurys|Wall Street|Japan|Plosser|Kaplan|Ron Paul|Dalio|Obama|Apple|Cashin|Janet Yellen|Marc Faber|FOMC|Schiff|JPMorgan|John Williams|Draghi|Bill Gross|CNBC Fed|Bridgewater|Bob|CME|Rosengren|Congress|Crescenzi|Hong Kong|Evans|Kashkari|Loretta Mester|Dow|UK|Says Banks Gain From Fed|Canada|Wells Fargo|Stan Druckenmiller|Citigroup|Goldman|Citi|White House|Druckenmiller|Harker|Merrill Lynch CIO|Santoli|Kudlow|Siegel|Ma Bell|Wall St|Dennis Gartman|Google|IMF|Jim Grant|Bank Break-Ups|Credit Suisse|Pimco|UBS|Mester|Senate|Kocherlakota|Eric Schmidt|Domm|LendingTree|PBOC|Dallas Fed|Merrill|El-Erian|Panama Papers|John Cochrane|Korea|BofA|Will Bank of England|ADP|Morgan Stanley|George Gilder?|Austan Goolsbee|El Erian|S&P|Obamacare|Wal-Mart|Dinan|Goldman Sachs|Santelli|Jeremy Stein|Rand Paul|BlackRock|Brexit|RBC|McCulley|Jon Tester|SocGen|Peter Schiff|QE|Jimmy Dunne|Ex-Obama|HK|Wells Fargo CEO|NPC|Paulson|Jeremy Siegel|Larry Sumers|Boeing|Kensho Stats|Caterpillar|Buffett|Kensho|South Korea|Treasury guarantee? Lehman|Sri Lanka|Powell|US Treasury|Vince Farrell|Richard Fisher|Bank of Japan|Fisher|Brazil|Patterson
Kate	William|UK
Kalmazoo	Michigan
Landis	Apple|Netflix
Santelli	Cruz|Borg|Fed
Zurich Insurance Group	George Quinn
Ant Financial	Alibaba
Steinhoff	Darty|Africa
Mills	Caitlyn Jenner|U.S.|US
Madden	Rutgers|Tomlinson
Silver Shield Foundation	George Steinbrenner
Wendy	McDonald|Burger King
Treasury	Puerto Rico|US|Congress|Pfizer-Allergan|CNBC|Lew|Fannie|Dimon|Cashin|Goldman|U.S.|Teamsters|Obama|Jack Lew|China|UK|White House
Manta	Donald Trump
Yoma	Myanmar
Hunan Dakang	Brazil
Tut	Egypt
China	US|Asia|Apple|Fed|Hong Kong|Japan|India|South China Sea|Europe|Beijing|North Korea|Facebook|Alibaba|U.S.|Russia|South Korea|IMF|CNBC|Cramer|Xiaomi|HK|PBOC|Soros|BOJ|Australia|Li|NPC|Moody|ECB|Trump|GE|Taiwan|Greece|Vietnam|Amazon|Google|France|Kyle Bass|UK|Donald Trump|BlackRock|Central Bank|Chanos|Huawei|Bass|Philippines|Jack Ma|Brazil|Singapore|Capital Economics|Congress|Jim Chanos|Radisson|John Rice|GOP|Microsoft|Tim Cook|S&P|Germany|Starwood|Hank Paulson|Tesla|Paulson|Iran|Shanghai|HNA|Airbus|Goldman|Dalian Wanda|Hollywood|Samsung|Icahn|Jaitley|Obama|Sinochem Group|Merkel|Bernanke|KKR|AB InBev|Cornell|U.N.|Citigroup|Ivanka Trump|Algeria|Hayman Capital|Bob Iger|Howard Silverblatt|Kate Moss|SKorea|Nomura|Ireland|Sec Lew|Sri Lanka|Batman|Weibo|Doha|Ackman|Siegel|UBS|Tepper|Alibaba IPO|AIIB|OECD|YouTube|Leif Johansson|US Congress|Surat|Cashin|Rio|Quintanilla|Reserve Bank of Australia|Ash Carter|WPP Martin Sorrell|Macau|El-Erian|Faber|Cuba|Zhu|Starbucks|Hu Wants U.N.|NKorea|Renault|America|UN|Siemens|Zuckerberg|Ericsson|Nadella|Yum|Barclays|SocGen|Boeing|NPL|Paris|Zimbabwe|Nielsen|Gazprom|Regina|Hague|Edmund Phelps|Jeff Immelt|Prada|COFCO|Statistics Bureau|World Bank|Ford|Caterpillar|Manchester United|South China Sea Island|Baidu|Beijing?|Middle East|Deutsche Bank|Giants|Lenovo|Rackspace|Tankan|Virgin|Nathan Blecharcyzk|OPEC|Qualcomm|KFC|S&P Dow Jones|Volvo|Dassault Systemes|GTM Research|NZ|Bank of Korea|ANZ|Nike|Le|BHP|IHS|Citi|MSCI|Sony|Times|Carl Icahn|Cook|Morgan Stanley APAC|HSBC PMI|Haier|SEC|Bombardier|Julius Baer|Indonesia|Fubon|US Navy|Kalanick|LG Household|Raymond James|SolarWorld|Adidas|Shanghai Comp|Anhui Conch|Venezuela|Williams|Goldman Sachs|London|Wall St|Xi Jinping|Christie|PMI|Not China Unicom|HK IPO|Novartis|Saudi Arabia|English Premier League|ING|FIA|Korea|AMAC|Samsung?|United States|Indiana|Airbnb|DSM|Delta|Marriott|Yoo Il-ho|Britain|Asia Infrastructure Investment Bank|Branson|Markets Right Now|Myanmar|Netflix|AIG|Treasury|Vivo|Blackstone
PKK	Ankara|Iraq|Turkey
Erdogan	Turkey
Indonesia	CNBC|Malaysia|ASEAN|PT Trans Media Corpora|China|US Fed|Singapore|Sumatra Island
Rex Ryan	NFL|Marc Trestman
HSBC PMI	China
WL Ross & Co.	Wilbur Ross
Alexa	Amazon
Bulgaria	EU
Angola	OPEC
Steve Ballmer	Microsoft|Jesse Jackson|Oxford|LA Clippers|NBA|Clippers
Buiter	Bullard|Citi
Stock Exchange	Deutsche Boerse
Caruso-Cabrera	Chavez
InterActiveCorp	Barry Diller
Jordan Spieth	Tiger
Crescenzi	Fed|U.K.|FOMC
NC	Clay Aiken|Durham
Digital Music Group Teams Up With YouTube	Tiki Barber
WellCare	Medicaid
John Chambers	Cisco
Eric Schneiderman	CNBC
HIBB	GCO|BOJA
Virginia Tech Merchandise	Topps Dollar|Curt Schilling
MSNBC	U.S.|OBAMA|SCALIA|HARRY REID
Ebersman	Sandberg|Facebook
Port Authority	COO Hart|United Airlines
Snowden	Hong Kong|Intel|Sony Pictures|NSA|UK
Iran	U.S.|US|Saudi Arabia|OPEC|Doha|Obama|Badri|Asia|China|Gartman|Rouhani|US House|US Navy|John Kerry|Iraq|U.N.|Cuba|Kerry|IHS|Chavez|London|Tehran|U.S. Supreme Court|FBI|Europe|Boeing|Airbus - Tasnim|UK|Russia|Ryan|Berkshire|United States|Israel|Brown
Ralph Nader	Pope Francis
Buy Marsh & McLennan	Power Corp.
Bangladesh Bank	SWIFT|NY Fed
ASX	US
Temer	EXCLUSIVE-Brazil
Vale	BHP|Brazil
SAMSUNG ELECTRONICS CO LTD	U.S.
HALLIBURTON	BAKER|US
Medicaid	Pennsylvania|Miss.|WellCare|Texas
Tracy Britt Cool	Todd Combs
United Farm Workers	California|Gerawan
Michael Kors	Lauder
Iraq	US|ISIS|OPEC|Turkey|Bush|PKK|Libya|Gabelli|Navy|IFC|Afghanistan|U.S.|Iran|Gulf|Unaoil|Singapore|Obama|Russia|Ankara
Pelosi	Warren|Cantor|Boehner
Trevi	Mosul|Italy
Catalonia	Spain
St. Louis	Boston
Davos	US|Dalio|Dimon|World Economic Forum|Joe|Cohn|Biden|Europe|JP Morgan|Milken
Jake Bronstein	Flint
Alex Salmond	Scotland
Qantas	Tino La Spina
Immofinanz	Lufthansa
N Korea	Arianna Huffington|Trump|Kim Jong
Novartis	Roche|Alnylam|Google|China
BNY Mellon	Gerald Hassell
Mercosur	Rousseff
Cannes	Zeppelin
UNH	NFLX|EBAY|IBM|YHOO|PNRA
Sherwin-Williams	Cramer
Bordeaux	Jack Ma
eBay	Amazon|Charlie Hebdo|PayPal|Etsy|Steve Jobs|Citrix
Marriott International	CNBC|Arne Sorenson
Politico	Jeb Bush
Lang Lang	CNBC
Kanye West	Mark Zuckerberg|Jay Z|Pablo
Pizza Hut	CIC|KFC|Yum China
Williams-Sonoma	Cramer
Thiel	Google|Icahn|Andreessen
El Mundo	Spain
Mouawad	Victoria
Siri	Apple
CNBC U.S. Video News Clips	Stock Market
PMI	Asia|US|China
Timer Warner Cable	FCC
New York	London|CNBC|S&P|Manhattan|Pemex|Byron Wien|North Carolina|Beware S&P|Hong Kong|Ed|Bank|Brussels|CME Group|CME|FanDuel|New Jersey|Tokyo|Donald Trump??|ECB|Pisani|Silicon Prairie|Virginia|Trump?|Amanda Drury|Waldorf|U.S.|Mexico|San Francisco|Donald Trump|Saudi Aramco|Ramapo|Pennsylvania
Robert Califf	U.S. Senate|Senate
OMV	Austria
COFCO	China
Hormel	America
ITT	CBS|AIG|WYNN|BA|NFLX
Dollar Shave Club	Gillette
Bergen	Norwegian Aviation Authority
Soros Fund Management	Synchrony Financial
Catholic Values	S&P
Putin-Obama	Russia
Richard Branson	VW|Virgin America
Gillette	Dollar Shave Club
Tim Hortons	Avis Budget
Rob Manfred	MLB
Tyson Foods?	Jim Cramer
Merkin	Madoff|Fairfield
New China	US|Lew
Ahold	DaimlerChrysler|Pearson|UCB|Bulgari
Will Fed	Asia
Terex	U.S.|EXCLUSIVE-China
Kremlin	Goldman Sachs|Russia|NATO
Gaal	United
Mueller	VW|Malaysia Airlines
Curt Schilling	ESPN Analyst|Virginia Tech Merchandise|Topps Dollar
Andrew Ross Sorkin	CNBC|Ken Moelis|Nelson Peltz
Airways	Airbus
Goldman	Blankfein|US|China|Barclays|Nomura|Boockvar|Federal Reserve|Bove|Treasury|Morgan Stanley|Apple|ANZ|Hatzius|O'Neill|Fed|Yahoo|ING|Ron Paul Blames Obama|S&P|USA|Asia|Trump|Kostin|Obama|IEA|Tesla
Paypal	Apple
Rollins	Zika
Hodges	JC Penney
Tidjane Thiam	CNBC
Margaret Thatcher?	London
Santa	Hilton
Piraeus Bank	Greece
Treasury guarantee? Lehman	Fed
Mindy	Fox
E.S. Kluft & Co	Inc|Brooklyn|Amy
Delphi Automotive	IRS
LULU	TSLA|LVS|CMG|NFLX|EMC
Unaoil	Iraq
Jim Paulsen	S&P
Mercedes	U.S.|Daimler
Modi	India|Hindustan|Xiaomi|Li|FDI
MCO	TIVO|DAL|TYC|VFC
Muhammad Ibrahim	Malaysia
Huffman	Reddit
Beverly Hills	Hamptons
Huckabee	GOP|White House|Ex-Arkansas|Walker|Obama
Donald	Trump|Time|RNC|GOP|Trump Tower|Ed McMahon
Rutgers	Tomlinson|Madden
Raiffeisen	Sberbank
Gerald Hassell	BNY Mellon
Croatia	Slovenia|MOL|Hungary
Haider Al-Abadi	CNBC
Carlyle	Rubenstein|Wilbur Ross
Sonders	Schwab
Trichet	Bernanke|Pimco|ECB|Brown
Paris	Beijing|Hollywood|United States|Hong Kong|Sydney|Japan|New York Times|Singapore|Air France KLM|Brussels|China|Warren Buffett|Facebook|Adele | Week|VW|US|Islamic State|EU|Defense|York Times|France|Salah Abdeslam|U.S.
Anthem	Cigna
Daley	Trump 's Islam
Andreessen	Facebook|Thiel|Icahn
Telecom Industry	Europe
Mouawad Singapore	Victoria
Kensho Stats	Fed
Ramapo	New York
Issa	House
Mahendra Negi	Trend Micro Inc.
Reddit	Huffman
Wells Fargo	Berkshire|U.S.|Tim Sloan|Buffett|Piper Jaffray|Fed|US|Wal-Mart|John Stumpf|Gina Martin Adams
Thomas Jefferson	US
Univar	Syngenta|Fyrwald
Federal Budget	U.S.
SPLS	TSN|NMBL|DSW|SWHC
San Fran	Beijing
MOSUL	OBAMA
Martin Cubbon	Swire Pacific Limited
Giuliani	Clinton
Lumia	Microsoft
Luxola	Singapore|Alexis Horowitz-Burdick
Twitter & Yelp	Cramer
GPN	INTC|NLSN
SONC	DRI|ORCL
Forbes Media	Hong Kong
Bruce Levenson	Atlanta Hawks
Elizabeth Holmes	Theranos
TCI	VW
Minnesota	Prince
Hague	Philippines|US|South China Sea|Russia|China
Julius Baer	China
Iguodala	NBA
Vorapak Tanyawong	Krungthai Bank|Thailand
Amanda Drury	New York|CNBC
Lockhart	Fed|Brexit|US
William Kristol	Trump|Romney
Michael Santoli	CNBC
Lahiru Pathmalal	Sri Lanka
Balboa Bank & Trust	U.S.
Re	Asia
New Jersey	David Tepper|Virginia|Florida|New York|VW|Atlantic City
Buchanan	Bush
Leon Black	Carl Icahn
Kraft Heinz Co.	HJ Heinz|Kraft Foods Group
Jharia	India
Silicon Prairie	New York|San Francisco
Seinfeld	J. Peterman
Gasparino	NYSE|CNBC|SEC
J Sainsbury	John Rogers
Einhorn	Ackman|Greenlight Capital|Ira Sohn|Tepper|Chanos|Athenahealth
Afghanistan	US|Iraq|Libya
Manchester United	Real Madrid|English Premier League|China
Aladdin	Alibaba
Sokol News	CNBC|Warren Buffett
FDI	India|Xiaomi|Modi
Murray Energy	EPA
Tesco	Makro Stores|Warren Buffett|Buffett
PBOC	China|Zhou|ECB|Yuan|Fed
Kumamoto	Japan
Philadelphia Airport	FAA
FDX	AAPL|BBBY|TWX|CMG
CRH	Lafarge|Holcim
Starwood Hotels	Marriott|Anbang
DIFC	Dubai
White	SEC
DeVry	FTC
Larry Ellison	Mark Hurd|Marco Rubio
Yoon Returns	CNBC
Wisconsin	GOP|Cruz|Sanders|USA|Waterloo|Trump
Not USA	Cramer
FANG	Paul Meeks|Cramer
Gina Martin Adams	Wells Fargo
Ira Sohn	Tepper|Einhorn|Ackman
Enerjisa	Sabanci
Pluto	NASA
Howard Dean	Bernie|Cruz-Kasich|Hillary
Yum Brands	Corvex|Keith Meister?
Harvard	MIT|US News & World Report|Yale|America|US|NFL
Gallup	Obamacare
Los Angeles	West Coast|Long Beach|San Francisco
Lazard	1-Ferro Corp|2-Ferro Corp
Republican	Cramer
SWIFT	Bangladesh Bank|NY Fed
Yankees	Bronx
AIIB	World Bank|China
Gartman	Greece|Iran
New York Fed	Bangladesh
Matt Damon	CNBC|Bourne|Mars
Dinan	Fed
Roku	Amazon|Apple|Google
NASCAR	Manhattan|Talladega Daves
Wu Tang	FBI|Shkreli
Mark Zuckerberg	Facebook|Lady Gaga|Kanye West|Donald Trump
Meeker	India
Eric Shinseki	VA
Chevy	Google|Apple
Palm Beach	Paul Tudor Jones
Peyton Manning	Richard Sherman|NFL
Zhou	PBOC|Yuan
Leslie Moonves	CNBC|CBS Corporation|CNBC Media Alert
RNC	Trump|Donald
Dombrovskis	Greece
Akiko Fujita	Japan|Fukushima
Tubman	U.S.|Trump
New York Times	Paris
Warren Buffett	CNBC|Bill Gates|US|U.S.|IBM|Charlie Munger|Coke|Trump|Omaha|S&P|Obama|NBC|Road|Wal-Mart|Hillary|Government Would Rescue Bank of America|Google|CNBC U.S. Inflation|Political Beliefs Into ` Blind Trust|Bezos|Becky Quick|Bill Miller|FACTBOX-Berkshire Hathaway|Barack Obama|Hillary Clinton|Bank Stocks|BNSF|Berkshire|Berkshire Hathaway Eliminates Stakes|Korea|Power Lunch Interview|Berkshire Hathaway|Larry Van Tuyl|Paris|Asia|Nebraska|America|Washington|Sokol News|CNBC Burlington Northern|Goldman Sachs|Berkshire Board|Berkshire Hathaway Buys Omaha Newspaper Despite Industry|Cramer|Goldman Sachs Unexpected|Legg Mason|Annual Stock Gifts to Charity|Buffett|South Korea|Europe|John Paulson|Chicago|Healthcare|Jack Welch|Tesco|Clinton|Burlington Northern|Jeff Bezos|Tom Brokaw|Michael Pearson
Barbie	Mattel|Cramer
Shkreli	FBI|Wu Tang
Luxembourg	Juncker|EU
Maersk	Qatar|MSC|CMA CGM
ASEAN	Singapore|Indonesia|Malaysia|AEC
Hef	Playboy Mansion
GOP Trump	Google
Jon Tester	Fed|Larry Summers
Broadspectrum	Ferrovial
KidZania	Singapore|India|Australia
Pandit	Citigroup|Citi
Orbitz	Cuba|Expedia
AZN	CBS|ULTA
Josh Brown	Prancercise|Victoria
Kim Jong Un	Sony|UN|North Korea
Yahoo	Marissa Mayer|Verizon|Google|Cramer|Alibaba|NSA|Microsoft|Yahoo Japan|IRS|Mayer|Bartz|Comcast|Smith|Dow|AOL|Yang|Bernanke|John Malone|Time Inc|Zumiez|Mahaney|Armstrong|Dan Loeb|Meeks|Obama|Goldman|US|Semel|Buy Tumblr|Liberty Media|SunTrust|Petsmart|Arqule|BrightRoll
Brooklyn	Madoff|Inc|E.S. Kluft & Co|New York State Sues Exxon|Amy
Main Street	Trump|Clinton
Zynga	Facebook|Mark Pincus
2-Ferro Corp	Lazard
Thailand	Vietnam|Vorapak Tanyawong|Casino|Krungthai Bank
Sanofi	US|Bristol|France
Sonnenfeld	Disney|Peltz
Osama bin Laden	CIA
Toronto	Ford
Winklevoss	Bitcoin
Thomas Staggs	Disney|Iger
Exxon	FuelCell|Chevron
North Dakota	Bakken|Top States|Williston
Veerathai Santiprabhob	CNBC|Bank of Thailand
Beware S&P	New York
Amadeus IT Group	Ana de Pro
Trump Tower	Trump|Donald
Mike Tyson	Las Vegas
IEA	Saudi Arabia|US|Russia|OPEC|Asia|Goldman|Birol
Tel Aviv	FAA
Norilsk	LionOre
Alpha Natural	W. Virginia
Marchionne	Ferrrari|Fiat Chrysler
Violet Grey	Hollywood Glamour
CDC	US|Zika|White House
Grace Lee	Astro Malaysia Holdings
Rick Perry	Texas Appears in Court|GOP
SBUX	AAPL|GE|AXP|STI|CVS
OECD	UN|World Bank|China|Japan|IMF
IndyMac	CNBC
Kasich	Trump|GOP|Cruz|Ohio|CNBC Fed|Wall St.|Sanders|Langone|Ken Langone
Taiwan	China|Fubon|Apple|Tsai|US|Japan|SKorea|Korea
Danamon	DBS
Cyprus	ECB|SXSW|Eurozone Faces Tough Bank Regime|CNBC|Nicos Anastasiades|EU|Turkey|Russia
Pfizer-Allergan	Treasury
Bethune	UAL
Robert Drake	Galaxy Entertainment Group
Prieto	Atlantic City
Astro Malaysia Holdings	Grace Lee
Amaggi	Louis Dreyfus|HSBC
Statoil	US|Shell|Algeria
Goldwater	Trump
Therkelsen	Denmark
Fmr CIA	FBI
Becky	Buffett Hosts Obama Fundraiser Tonight
CNBC Titans	Mavericks
Canada?	Trump
Bangkok	Erawan
Halliburton	Baker Hughes|US Justice Department
Miley Cyrus	Indiana
Oxford	Steve Ballmer
Natch	Mayer|Tech Star Pogue
Etsy	Herbalife|Tesla|Amazon|Cramer|eBay
Philip Green	CNBC|Topshop|Panama|Bangladesh
JCP	BHI|AIG|Bill Ackman|NVO|BBY|MEG|NFLX|NKE|YHOO
Piper Jaffray	Wells Fargo
MTS	Alexey Kornya
MOL	Croatia
MTV	YouTube
Brad Stevens	Butler
Reid	Obama|Scalia|U.S.
Wal-Mart	Cramer|Kohl|US|Warren Buffett|Apple|Sears|CNBC|Fed|Supreme Court|AIG|Coke|Amazon|Wells Fargo|U.S. Supreme Court|USA|NBA|U.S.|Simon|Bezos
Will Bank of England	Fed
Carmike	AMC Entertainment
MTN	DG
BRIC	India
Shake Shack	North Carolina
American Eagle Outfitters	Western Europe
Crucial Calif.	NASA
Jose Antonio Gonzalez Anaya	Pemex
Houston	Intermarine|Texas
Harvard Business	Dick Costolo
Deezer	Apple Music
Carfax	U.S.
Lee Sedol	Google
Gawker?	Bill
Senate	House|U.S.|Puerto Rico|Obama|Harry Reid|North Korea|Washington|IRS|Fed|Mandel|Valeant|Keystone|GOP|Shinseki|Takata|Caterpillar|Brazil|McConnell|US Airlines|White House|Garland|Rousseff|Robert Califf|Ohio|Tracy Morgan|Yellen|Garcia Padilla
FuelCell Energy	Cell Power Plant for Data Center Project With Microsoft Corporation
CSCO	Cisco Systems Inc
Lebenthal	Apple
UPS	Amazon
Erik Weihenmayer	Everest
ANZ	Barclays|ING|Goldman|Nomura|China
Gorman	Morgan Stanley
ExxonMobil	AAA|S&P
Sprint	T-Mobile|U.S.|Google|Qualcomm
Joachim Fels	US
Ben Carson	Trump VP
HNA	Radisson|China
BG	Shell
BA	NFLX|CBS|NOC|WYNN|ITT|AAPL|BHI|GRMN|AIG
Asia Infrastructure Investment Bank	U.S.|China
Charles Evans	Steve Liesman|Federal Reserve Bank of Chicago|CNBC
John Ramsay	Syngenta
BI	RBA
Burlington Northern	Warren Buffett
BT	EE
South China Sea Island	US|China
Steven Cohen	U.S.
San Francisco	US|Rhode Island|New York|Jeb Bush|SEC|Los Angeles|Silicon Prairie|Google|Raimondo
TIF	VIAB|GE|WFM|KORS|CPGX|AAPL|AIG|HRL
EXCLUSIVE-Investor Gabelli	Viacom
Galaxy Entertainment Group	Robert Drake
Cayman Island	Great Plains
Bahrain	Moody|Oman|McLaren|Gulf|Saudi Arabia
Wolfsburg	VW|Volkswagen
Lentz	Toyota
Mario	Janet|Nintendo
U.S. FCC	Netflix
YouTube	Google|Bethany Mota|Taylor Swift|Facebook|Alibaba|Hasbro|MTV|China
Watson	IBM
ATHM	GM|MDVN
Victoria	Secret Angels|Mouawad|L Brands|Josh Brown|Jim Cramer|Mouawad Singapore
APEC	Bush|Sydney|Howard Cement Alliance|Putin
Boston Travel	New York-Boston
Starbucks	Dunkin|McDonald|Italy|US|Milan|Percassi|Utah|Bloomindale|Cramer|Chicago|China
Orange County	California
Kraft	L Brands
Hermes	Jane Birkin
AutoNation	Tesla|Volkswagen|VW
Pearson	Bulgari|UK|UCB|Ahold|DaimlerChrysler
Lacker	Fed|US|Cashin
Alan Greenspan	CNBC|Sara Eisen|Former Federal Reserve
Wall St	US|S&P|CNBC|Apple|Hillar Clinton|China|Fed
Greenland	Fiji
Barack Obama	Chicago|Reform NSA|Warren Buffett
Silicon Valley	Apple|Intel|White House|Texas|Eastern Europe|Andy Grove|Oracle|Bill Campbell|Colorado|Israel|Andrew Grove|Trump|Hollywood|Facebook|ISIS
Karl Rove	White House
Talladega Daves	NASCAR
Geraldine Matchett	DSM
Arqule	Zumiez|Petsmart|Yahoo
Priceline.com	U.S.
Qatar Air	Dubai
England	Carney|Bitcoin|UK|EU
Pirates	Caribbean
Nadella	Microsoft|China
China?	Google|Mobvoi
Ernst & Young	Madoff
DuPont	Trian|Dow|PepsiCo|Dan Loeb|Liveris|Peltz|Caterpillar
Isaacson	Elon Musk
Cheung	RUSAL
Intesa Sanpaolo	European Central Bank
Time Inc	Yahoo
Jasper	Microsoft
Power Lunch Interview	Warren Buffett
Warren Buffett?	Berkshire Hathaway
Mustafa Tercan	Yildiz
Saipem	Algeria
Canadian National Railway &	Sanmina
United Tried	Branson
Milken	Madoff|Davos|Brown|California
Oprah	Zuckerberg|Whoopi Goldberg
China Telecom	Alibaba
Crossroads After Big New York	Donald Trump
G-8	Japan
Harwood	CNBC
Former Federal Reserve	Sara Eisen|CNBC|Alan Greenspan
TYC	TIVO|DAL|VFC|MCO
Bartz	Yahoo
Global Financial Markets	CNBC World Television Network|Asia|Europe
Bank of Japan	Asia|Fed
Energy Future Holdings	Oncor
LLY	PNRA|AAPL
Time Warner	U.S.|EchoStar|HBO|CBS|Moonves|Carl Icahn
Vladimir	Vince Farrell
Barron	Bank of America|Ford|GM
Singapore	Apple|Asia|China|Hong Kong|Malaysia|Lee Kuan Yew|US|Paris|Reebonz|NODX|Seoul|Emmanuel Stroobant|KidZania|CEBR|Indonesia|U.S.|Hong Kong Look|Changi Airport|Iraq|Europe|ASEAN|Cuba|Zurich Insurance|Narendra Modi|India|Kate Middleton|PSI|Israel|Switzerland|Luxola|Alexis Horowitz-Burdick|Edina Hong|Southeast Asia|UOB|Lee|Samsung|Australia
SolidFire	NetApp
Moglia	NCAA
Schwab	Sonders
TEVA	Teva Pharmaceutical Industries Ltd|TSN|BRKB|HCP
SocGen	US|Fed|Trump|S&P|China
Cherie Blair	CNBC|Thatcher|Tony
Barroso	Greece
Calamander Group	Sri Lanka
Zillow	Glu Mobile|Priceline|Suntrust
HJ Heinz	Kraft Heinz Co.|Kraft Foods Group
NY Fed	Bangladesh Bank|SWIFT
Scott Cohn	Irving Picard|David Sheehan|CNBC
Geithner Implies	US
CBS Profit Falls	Lower TV
Microsoft	Apple|Google|Nokia|Amazon|Nadella|Ballmer|Cramer|China|Yahoo|NSA|Bill Gates|Elop|Sony|Lumia|Jasper|Icahn|Intel|Wachovia|Ford|Dreamforce|John McAfee|Najarian|Dell|Kaminsky|Motorola|Nintendo|Satya Nadella|Eric Schmidt|UK|Steve Ballmer|Samsung|Caterpillar|Lenovo
North Korea	China|US|Kim|UN|Russia|Obama|Japan|Seoul|Apple|Kim Jong Un|Congress|U.S.|Senate|Security Council|White House|Sony|U.S. House
Arminio Fraga	Brazil|Neves
Johnny	US
Enda Kenny	Taoiseach|CNBC
Ken Griffin	Citadel|Time Warner-Fox|Marco Rubio
SoftBank	Netflix|Japan|Google|US
US	China|Fed|Asia|Europe|OPEC|S&P|Apple|Trump|North Korea|Obama|BOJ|Yellen|Google|Iran|UK|EU|Syria|Cuba|Russia|Zika|Canada|Wall St|Iraq|CDC|Warren Buffett|Dudley|MetLife|ISIS|South China Sea|St|Panama|Alibaba|Samsung|Facebook|CNBC|Havana|Japan|Wal-Mart|Treasury|Germany|Puerto Rico|Sony|Evans|Mexico|Davos|Citi|Saudi Arabia|Islamic State|Xiaomi|California|Panama Canal|NPC|Donald Trump|Ford|GOP|Volkswagen|Icahn|Pimco|NSA|Goldman|Ryan|Blackstone|ASX|Israel|Goldman Sachs|Williams|Singapore|Ash Carter|Honda|RBA|Huawei|Rubio|ECB|Brussels|Lew|Amtrak|San Francisco|Adelson|SoftBank|Rackspace|Malik|Egypt|Hague|Lippo|Simon|Barra|Viacom|Taco Bell|US House|Sunil Gulati|Beijing|BP|Harris|Megan Smith|Dow|Bank of Korea|Wikipedia|Sports Authority|Harvard|Trump White House|Congress|Kyle Bass|Crimea|Citadel|Philippines|Bill Clinton|Soros|JPMorgan Chase|India|HALLIBURTON|Hungary|Lockhart|Nasdaq|Aereo TV|Yahoo|U.S.|Ben Bernanke|Mass Mutual Life Insurance|China Data Set Negative Tone|Tim Cook|Paulson|Seagate Technology|Sanofi|Mills|Narendra Modi|Wells Fargo|Malaysia|Dalio|J&J|Farrell|NKorea|Skype|Tankan|Cruz|Silk Road|Statoil|Labor|Cheniere|Navy|Merkel|PMI|Seattle|New China|Laffer|Jessye Norman|UN|United Airlines|Global|Rajaratnam|Hyman Roth|Bangladesh|Moody|Fischer|Australia|Stephen Schwarzman|House|Kashkari|San Francisco Fed|Paris|USA|Texas|Zuckerberg|Gulf of Mexico|Ma Bell|Lacker|Allergan|America|Lance Armstrong|AT&T|Algeria|Bill Gross|Afghanistan|Washington|Jack Ma|Dole|Dick Bove|Cerberus|Conrad|Pickens|South America|Greece|ADP|EIA|Walmart|Social Security|New England Patriots|Bernie Sanders|Murkowski|Primark|Mester|France|IEA|Mark Grant|FBI|Kaplan|Libya|Macy|Najib Razak|Jamie Dimon|JPMorgan|Kocherlakota|Bank of America|Larry Summers|Federal Reserve|ACLU|BAKER|EPA|BEA|Harold Hamm|Pope|Taiwan|Reuters|White House|Dimon|FOMC|Starbucks|Keystone|UBS|Fiat Chrysler|Nigeria|Rogoff|Barclays|El Nino|Ukraine|Thomas Jefferson|Vietnam|Takata|Kudlow|Hillary Clinton|Theranos|John Stumpf|Doha|South China Sea Island|Joachim Fels|James Patterson|Oppenheimer|US Energy Agency|Geithner Implies|Johnny|Gucci|IMF|YPO|Pearl Harbor|SocGen|Sherry Lansing|Cohn|Abercrombie|Quest Diagnostics|Moynihan|Africa|Morgan Stanley|FAA
Lee Seow Hiang	Changi Airport Group?|Top Travel|CNBC
South America	US
UN	North Korea|OECD|Libya|World Bank|China|IMF|Kim Jong Un|US
AstraZeneca	Pfizer|ASCO
Heathrow	UK
UK	EU|Cameron|US|Brexit|Osborne|David Cameron|ISIS|Abe|Trump|Panama|France|Europe|HSBC|China|Tata|London|Obama|KidZania London|Donald Trump|Ex-Deutsche Bank|NHS|Sadiq Khan|Krugman|Cameron Wants Europe|Credit Suisse|Stephen Hawking|Treasury|England|Tata Steel UK|Pearson|Labou|Parliament|Japan|Prudential|HK|Tata Steel|Yanis Varoufakis|RBS|Kate|McCormick|Snowden|Heathrow|US FDA|Tory|Conservative|William|Lee|Margaret Thatcher|Peng|Iran|Carney|Deutsche Boerse|Microsoft|Nissan|U.S.|Miliband|Manchester|Scotland|Ireland|IMF|Brown|Saudi Arabia|Fed
Buick	Odell Beckham Jr
Japan	China|Asia|Abe|South Korea|Fed|US|Fukushima|BOJ|Trump|EU|Australia|Takata|U.S.|Brexit|Netflix|Europe|Tokyo|SKorea|Kumamoto|Taiwan|PIMCO|Kuroda|Morgan Stanley|Kyushu|Mekong|Akiko Fujita|El-Erian|JPMorgan|Naoto Kan|Abenomics|Bank of Thailand|Charlie Munger|SoftBank|North Korea|BlackRock|Yellen|Lyft|Korea|G-8|Morici|OECD|UK|Rakuten|Dennis Gartman|Kyle Bass|GM|Paris|Softbank|Congress|NPC|Suntory|Mazda|Shinji Fukuyo|Blatter|M'bishi Motors|Toshiba|Mohamed El-Erian|NTT Data|HSBC|Beijing|McDonald|Viber Media|Dell|Buddhist|ECB|TPP
UA	GM|DHI
Stephen Schwarzman	Blackstone|US
Sadiq Khan	London|Labou|UK
Axalta	Jeff Gordon|NYSE
Cornell	China
Anadarko	AIG
Medicines Co	Italy
Ana de Pro	Amadeus IT Group
Rexam	Ardagh|Ball Corp
Lutnick	Cantor Fitzgerald
CNN	Trump
Richard Fisher	Fed
David Sheehan	Irving Picard|Scott Cohn|CNBC
Keystone	Obama|Nat|US|Nebraska|OPEC|Senate|Google
Wallabies	John Key|All Blacks
Jeff Bezos	Amazon|Larry Page|Sergey Brin|DC|Warren Buffett
Nelson Peltz	Pepsi|CNBC|Andrew Ross Sorkin|Ken Moelis
James Bullard	Federal Reserve Bank of St. Louis|CNBC
Federal Reserve Bank of Philadelphia	Patrick Harker
Max Levchin	PayPal
Amy	Brooklyn|E.S. Kluft & Co|Inc
Wu-Tang Clan	RZA
Gerawan	United Farm Workers|California
Wall St.	Sanders|Kasich|Hillary|Obama|Clinton
Micheal Keaton	Ray Kroc|McDonald
FED	Hollande
Mavericks	CNBC Titans
Aston Martin	James Bond?
Detroit	Dan Gilbert|Russia|Cleveland Cavaliers|Alaska|Christie|Motor City
American Apparel	USA
Boehner	Pelosi|Cantor|GOP|House|McCarthy
Activision	Endo|ESPN|Herbalife
Welt	Berlin
CNBC U.S. Inflation	Warren Buffett
Nasty Gal	Amoruso
Healthcare	Dick Fuld|Bill Poole|Warren Buffett
Times Square	FAO Schwarz
Howard Silverblatt	China|S&P Dow Jones
Seychelles	Malaysia
ABLA	Hitachi|Nakanishi
Dassault Systemes	China
Arianna Huffington	N Korea|Trump|Kim Jong
Britain	EU|Merkel|Wesfarmers|Germany|Australia|Strauss-Kahn|HSBC|Labour|U.S.|China
Saudi Aramco	London|New York|Hong Kong
Hank Paulson	China|JPMorgan Chase|Jamie Dimon
Ed Garden	GE
Swisscom	Fastweb Board|Italy|Fastweb
CIC	Pizza Hut|KFC|Yum China
CIA	Panama|Osama bin Laden|Malaysia Airlines|AT&T
Semel	Yahoo
Jeff Ubben	ValueAct
Berkshire	Buffett|Coke|Wells Fargo|BNSF|Deere|Iran|Munger|Warren Buffett|Omaha|Trump|Florida
Southeast Asia	Singapore|Jakarta|Malaysia|Narendra Modi
Kevin Spacey	CNBC
IFC	Iraq
Vancouver	Molson Coors
Moody 's Backs US 's AAA Rating	S&P Cuts Fannie
Rehn	EU
MSC	EU|CMA CGM|Maersk
Wedbush	Trump
Slovakia	Ukraine
Abenomics	Japan|Abe
House of Representatives	Pentagon
DAL	CME|MCO|TIVO|TYC|BAC|TWTR|VRX|VFC
Neves	Brazil|Arminio Fraga
Elsa	Disney|Anna
Utah	CNBC|Arizona|Starbucks|Idaho
Wells	Leon Cooperman
Knight Frank	NZ|Asia|Australia
Lufthansa	U.S.|Immofinanz
ORCL	DRI|SONC|Oracle Corp
Kerkorian	Chrysler
Crispin Odey	Paul Marshall|Brexit
United Airlines	CNBC|Jim Cramer|Oscar Munoz|Netflix|Macy 's|Port Authority|COO Hart|FAA|US
Datai	Lombok Lodge|Upper House|Asia
Pataki	White House
Dennis Nally	PwC
Yves Mersch	CNBC|European Central Bank
Tullett Prebon	Martin|ICAP
Lady Gaga	Mark Zuckerberg
Cigna	Anthem|Medicare Advantage
Deere	Berkshire|Buffett
David Cush	Virgin America|Alaska Air|Brad Tilden|CNBC
Wedbush Securities	FINRA
Moldova	Crimea|Russia
Kat Cole	Cinnabon
BlackBerry Messenger	Chen
Amazon Studios	Woody Allen
Tsipras	Greece|Lew
Melco	Batman|Lawrence Ho
ArcelorMittal	Man Group
Justice Department	VW|Apple|FBI|Enron
Priscilla Zuckerberg	Mark
Sri Lanka	Fed|India|HSBC|Lahiru Pathmalal|IMF|Calamander Group|China
Chambers	Cisco
Harker	Fed|Bullard
Michigan	Flint|Snyder|GM|State|Trump|Clinton|Idaho|Tennessee|Donald Trump|Kalmazoo|Hillary Clinton|Germany|Mississippi|GOP
Greenwich Meantime	SABMiller
